abominable=[#sad,#scared,abhor,offensiveness,unequivocally_detestable,abhorrence,detestable]

abort=[#sad,#scared,miscarriage,end,exhaust,terminate_a_pregnancy_by_undergoing_an_abortion,conceive]

abruptly=[#sad,#scared,sudden,abrupt,disconnected,precipitous,sharp]

abscond=[#sad,#disgusting,bolt,flee,abscondment,run_away,absconder]

abusive=[#sad,#scared,expressing_offensive_reproach,scurrility,mistreat,abuse,characterized_by_physical_or_psychological_maltreatment]

abyss=[#sad,#scared,bottom_of_sea,chasm,computer_game,bottomless_pit,fictitious_character]

acerbate=[#sad,#scared,acerbity,a_sharp_sour_taste,change,tartness,bitterness]

acrimonious=[#sad,#scared,marked_by_strong_resentment_or_cynicism,bitterness,mean_spirit,bitter,resentment]

admonish=[#sad,#angry,rebuke,knock,admonition,upbraider,reproof]

admonisher=[#sad,#scared,defender,someone_who_gives_a_warning_so_that_a_mistake_can_be_avoided,guardian,protector,shielder]

admonition=[#sad,#scared,rebuke,a_firm_rebuke,cautionary_advice_about_something_imminent,advice,monition]

adversary=[#sad,#scared,someone_who_offers_opposition,person,antagonism,agonist,cartoon_character]

adverse=[#sad,#scared,inauspiciousness,adversity,contrary_to_your_interests_or_welfare,in_an_opposing_direction,a_state_of_misfortune_or_affliction]

afflictive=[#sad,#scared,afflict,pain,discomfort,cause_great_unhappiness_for,causing_misery_or_pain_or_distress]

agonize=[#sad,#scared,agony,a_state_of_acute_pain,suffer,intense_feelings_of_suffering,expressing_pain_or_agony]

allege=[#sad,#scared,say,assert,allegation,declared_but_not_proved,doubtful_or_suspect]

allergic=[#sad,#scared,hypersensitivity,allergy,hypersensitivity_reaction_to_a_particular_allergen,pathological_sensitivity,allergic_reaction]

aloof=[#sad,#scared,distance,aloofness,remote_in_manner,length,space]

ambiguous=[#sad,#scared,ambiguity,multivalent,unambiguous,polysemous,an_expression_whose_meaning_cannot_be_determined_from_its_context]

ambivalence=[#sad,#scared,mixed_feelings_or_emotions,feel,ambivalency,spirit,tone]

amputate=[#sad,#scared,medicine,amputation,amputator,cut,remove]

anarchist=[#sad,#scared,syndicalism,nihilism,an_advocate_of_anarchism,radical,less_violent_world]

anarchistic=[#sad,#scared,anarchism,a_political_theory_favoring_the_abolition_of_governments,anarchist,nihilist,syndicalist]

anemic=[#sad,#scared,anemia,a_deficiency_of_red_blood_cells,a_lack_of_vitality,animal_or_body_part,anaemia]

annihilate=[#sad,#angry,destruction_event,destroyed_completely,eliminate,extinguish,eradicate]

anomalous=[#sad,#scared,anomaly,deviating_from_the_general_or_common_order_or_type,a_person_who_is_unusual,anomalousness,unusual_person]

antagonistic=[#sad,#scared,antagonism,antagonist,used_especially_of_drugs_or_muscles_that_counteract_or_neutralize_each_other's_effect,adversary,antacid]

apologist=[#sad,#scared,apology,a_person_who_argues_to_defend_or_justify_some_policy_or_institution,advocate,apologia,excuse]

arbitrary=[#sad,#scared,nonarbitrary,capricious,flightiness,absolute,discretionary]

arrogant=[#sad,#scared,egotism,ego,arrogance,having_or_showing_feelings_of_unwarranted_importance_out_of_overbearing_pride,self-importance]

arrogantly=[#sad,#scared,arrogant,self_importance,chesty,self-important,big-chested]

asinine=[#sad,#scared,asininity,vacuousness,inanity,devoid_of_intelligence,absurdity]

aspersion=[#sad,#scared,an_abusive_attack_on_a_person's_character_or_good_name,baptism,a_disparaging_remark,disparagement,attack]

autocratic=[#sad,#scared,foreman,offensively_self_assured_or_given_to_exercising_usually_unwarranted_power,bossy,dominating,high-and-mighty]

awfulness=[#sad,#scared,a_quality_of_extreme_unpleasantness,unpleasantness,dreadfulness,horridness,terribleness]

ax=[#sad,#scared,chop_wood,cut_wood,hardware_store,an_edge_tool_with_a_heavy_bladed_head_mounted_across_a_handle,useful_tool]

backbite=[#sad,#angry,defamer,complain,gripe,bitchery,maligner]

backwoods=[#sad,#scared,country,musical_work,country_music,state,nation]

badly=[#sad,#scared,bad,disadvantageous,very_intense,in_a_disadvantageous_way,severe]

bane=[#sad,#scared,affliction,fictitious_character,cartoon_character,curse,scourge]

banishment=[#sad,#scared,exclusion,rejection_by_means_of_an_act_of_banishing_or_proscribing_someone,the_state_of_being_banished_or_ostracized,rejection,excommunication]

bashful=[#sad,#scared,scotland,abashment,self_consciously_timid,blate,Scotland]

batty=[#sad,#scared,have_bat_in_one's_belfry,computer_game,have_bat_in_one's_belfry,software_object,video_game]

beastly=[#sad,#scared,bestialize,brutalize,animal,resembling_a_beast,beastliness]

bedlam=[#sad,#scared,mental_hospital,lunatic_asylum,cartoon_character,loony_bin,insane_asylum]

beggar=[#sad,#disgusting,indigence,pauperization,pauper,a_pauper_who_lives_by_begging,defy]

belabor=[#sad,#angry,knock,work_at,knocking,roast,bash]

belated=[#sad,#scared,lateness,after_the_expected_or_usual_time,tardiness,same_as_overdue,late]

berserk=[#sad,#scared,scandinavian,cartoon_character,fictitious_character,electronic_rock,comic_character]

beseech=[#sad,#disgusting,suppliant,mendicant,petitionary,adjuratory,importunate]

bitch=[#sad,#angry,slang,difficulty,canine,piss_and_moan,slang_expression]

bitterly=[#sad,#scared,bitter,acrimonious,bitterness,acerb,acerbic]

bizarre=[#sad,#scared,outlandishness,conspicuously_or_grossly_unconventional_or_unusual,abnormality,craziness,eccentricity]

blah=[#sad,#scared,boredom,colloquialism,yada_yada_yada,blah_blah_blah,ennui]

blameworthy=[#sad,#scared,blame,blameworthiness,attribute_responsibility_to,deserving_blame_or_censure_as_being_wrong_or_evil_or_injurious,a_reproach_for_some_lapse_or_misdeed]

blaspheme=[#sad,#scared,talk_of,blasphemer,curse,curse_word,expletive]

blasphemy=[#sad,#scared,profanity,disrespect,profanation,desecration,sacrilege]

blatant=[#sad,#scared,blatancy,shrillness,without_any_attempt_at_concealment,the_property_of_being_both_obvious_and_offensive,conspicuously_and_offensively_loud]

blather=[#sad,#disgusting,gibberish,blatherskite,babble,smatter,blether]

blockage=[#sad,#scared,an_obstruction_in_a_pipe_or_tube,the_act_of_blocking,obstruction,the_act_of_obstructing,block]

blotchy=[#sad,#scared,blotch,blotch_thing,blotched,splotched,splodge]

blurt=[#sad,#disgusting,art_rock,experimental_rock,psychedelic_rock,periodical_literature,music_magazine]

boastful=[#sad,#scared,brag,exhibiting_self_importance,boastfulness,bragging,crow]

bogus=[#sad,#scared,imposter,bastard,hypocrite,impostor,pretender]

bombard=[#sad,#angry,bomb,bomber,a_person_who_plants_bombs,attack,throw_bombs_at_or_attack_with_bombs]

bombastic=[#sad,#scared,turgidity,ostentatiously_lofty_in_style,pretentiousness,bombast,turgidness]

bondage=[#sad,#scared,subjugation,the_state_of_being_under_the_control_of_another_person,forced_submission_to_control_by_others,sexual_activity,slavery]

bonkers=[#sad,#scared,tv_show,television_show,grime,musical_work,freeform_hardcore]

bowdlerize=[#sad,#angry,expurgation,expurgator,bowdlerization,abridge,bowdler]

boycott=[#sad,#angry,ostracize,protest,patronize,banish,ban]

bragger=[#sad,#scared,egotist,egoist,swellhead,braggart,boaster]

brash=[#sad,#scared,crust,offensively_bold,brashness,boldness,cheeky]

bravado=[#sad,#scared,ostentation,musical_work,fanfare,flash,ostentatiousness]

brazen=[#sad,#angry,defy,brass,music_single,tv_show,brass_instrument]

breach=[#sad,#angry,open,failure,a_failure_to_perform_some_promised_act_or_obligation,an_opening,rupture]

bribery=[#sad,#scared,the_practice_of_offering_something_in_order_to_gain_an_illicit_advantage,felony,corrupt_country,advance_your_career,good_job]

brimstone=[#sad,#scared,sulfur,fictitious_character,cartoon_character,S,sulphur]

browbeat=[#sad,#scared,wheedle,bully,cajole,palaver,blarney]

brutal=[#sad,#scared,harsh,barbarous,cruel,fell,roughshod]

brutality=[#sad,#scared,atrocity,a_brutal_barbarous_savage_act,ferociousness,viciousness,savagery]

brutalize=[#sad,#scared,change,brutalization,an_act_that_makes_people_cruel_or_lacking_normal_human_qualities,the_activity_of_treating_someone_savagely_or_viciously,cause_to_change]

buggy=[#sad,#scared,carriage,bugginess,bug,shop_cart,wheel_vehicle]

bulkiness=[#sad,#scared,an_unwieldy_largeness,largeness,massiveness,breadth,comprehensiveness]

bulky=[#sad,#scared,bulk,bulkiness,the_property_of_something_that_is_great_in_magnitude,majority,mass]

burdensome=[#sad,#scared,burdensomeness,not_easily_borne,onerous,taxing,heaviness]

byzantine=[#sad,#scared,byzantine_empire,orthodox_church,complicatedness,a_continuation_of_the_roman_empire_in_the_middle_east_after_its_division_in_395,byzantium]

cackle=[#sad,#scared,cry,laugh,a_loud_laugh_suggestive_of_a_hen's_cackle,babbler,cackler]

cancerous=[#sad,#scared,cancer,relating_to_or_affected_with_cancer,malignant_neoplastic_disease,Cancer,Crab]

capitulate=[#sad,#scared,capitulation,surrender,wave_white_flag,fall,resignation]

capricious=[#sad,#scared,flightiness,notion,caprice,changeable,determined_by_chance_or_impulse_or_whim_rather_than_by_necessity_or_reason]

capriciously=[#sad,#scared,capricious,changeable,freakish,impulsive,whimsical]

capriciousness=[#sad,#scared,inconstancy,faithlessness,falseness,fickleness,changefulness]

capsize=[#sad,#angry,overturn,seafaring,shipwreck,keel_over,turn_turtle]

caricature=[#sad,#scared,mock,a_representation_of_a_person_that_is_exaggerated_for_comic_effect,wit,imitation,impersonation]

carp=[#sad,#angry,domestic_carp,cyprinidae,cyprinid,freshwater_fish,live_thing]

cataclysmal=[#sad,#scared,calamity,catastrophe,disaster,tragedy,cataclysm]

catastrophic=[#sad,#scared,ruin,an_irrecoverable_state_of_devastation_and_destruction,extremely_harmful,ruination,dilapidation]

caustic=[#sad,#scared,corrosive,mordant,of_a_substance_especially_a_strong_acid,any_chemical_substance_that_burns_or_destroys_living_tissue,corrode]

cautionary=[#sad,#scared,ward_off,prophylactic,admonitory,exemplary,monitory]

censure=[#sad,#angry,disapprobation,harsh_criticism_or_disapproval,animadversion,excommunication,exclusion]

chaotic=[#sad,#scared,chaos,a_dynamical_system_that_is_extremely_sensitive_to_its_initial_conditions,completely_unordered_and_unpredictable_and_confusing,disorderliness,lacking_a_visible_order_or_organization]

chastise=[#sad,#angry,chide,call_on_carpet,castigation,censure_severely,a_severe_scolding]

chatter=[#sad,#scared,chatterer,prattler,cut,talk,an_obnoxious_and_foolish_and_loquacious_talker]

cheaply=[#sad,#scared,cheap,brassy,relatively_low_in_price_or_charging_low_prices,inexpensive,flash]

choppy=[#sad,#scared,chop,choppiness,rough_with_small_waves,jerky,chop_shot]

chronic=[#sad,#scared,medicine,being_long_lasting_and_recurrent_or_characterized_by_long_suffering,habitual,degenerative,of_long_duration]

chunky=[#sad,#scared,ball,like_or_containing_small_sticky_lumps,squatness,dumpiness,hunk]

clunky=[#sad,#scared,thump,gawky,clumsy,ungainly,unwieldy]

coarse=[#sad,#scared,boorishness,granulate,farinaceous,of_textures_that_are_rough_to_the_touch_or_substances_consisting_of_relatively_large_particles,coarseness]

cocky=[#sad,#scared,bumptiousness,cockatoo_farmer,blue_rock,southern_rock,cockiness]

coercive=[#sad,#scared,coerce,hale,squeeze,pressure,force]

collusion=[#sad,#scared,agreement,group_activity,intentional_action,understanding,correspondence]

combust=[#sad,#scared,flip_one's_lid,anger,choler,ire,angriness]

complex=[#sad,#scared,compound,a_conceptual_whole_made_up_of_complicated_and_related_parts,consisting_of_two_or_more_substances_or_ingredients_or_elements_or_parts,composite,byzantine]

compulsive=[#sad,#scared,compulsion,a_person_with_a_compulsive_disposition,an_irrational_motive_for_performing_trivial_or_repetitive_actions_even_against_your_will,caused_by_or_suggestive_of_psychological_compulsion,person]

conceited=[#sad,#scared,conceit,vanity,amour_propre,ego,egotist]

condemnable=[#sad,#scared,reprehensibility,bringing_or_deserving_severe_rebuke_or_censure,reprehend,criminal,deplorable]

condemnation=[#sad,#scared,law,the_act_of_condemning_or_judging_to_be_unfit_for_use,the_condition_of_being_strongly_disapproved_of,disapproval,condition]

condescend=[#sad,#scared,condescension,act,perform_an_action_or_work_out_or_perform,superciliousness,disdainfulness]

confess=[#sad,#scared,fink,confessor,confession,an_admission_of_misdeeds_or_faults,admit]

confrontational=[#sad,#scared,confrontation,a_hostile_disagreement_face_to_face,the_act_of_hostile_groups_opposing_each_other,a_bold_challenge,in_your_face]

conspicuously=[#sad,#scared,inconspicuously,blatant,blazing,conspicuous,clamant]

conspiracy=[#sad,#scared,plot,set,a_plot_to_carry_out_some_harmful_or_illegal_act,politics,a_secret_agreement_between_two_or_more_people_to_perform_an_unlawful_act]

conspirator=[#sad,#scared,a_member_of_a_conspiracy,criminal,conspiracy,coconspirator,plotter]

conspiratorial=[#sad,#scared,conspiracy,conspirator,conspire,engage_in_plotting_or_enter_into_a_conspiracy_swear_together,a_secret_agreement_between_two_or_more_people_to_perform_an_unlawful_act]

conspire=[#sad,#scared,interact,plot,act_in_unison_or_agreement_and_in_secret_towards_a_deceitful_or_illegal_purpose,connivance,conspirator]

contaminate=[#sad,#angry,contaminant,change,contamination,the_state_of_being_contaminated,mercury_contaminate]

contamination=[#sad,#scared,the_act_of_contaminating_or_polluting,decontamination,the_state_of_being_contaminated,soil,impurity]

contemptuous=[#sad,#scared,contemptuousness,contempt,open_disrespect_for_a_person_or_thing,expressing_extreme_contempt,condescension]

contemptuously=[#sad,#scared,contemptuous,contumelious,disdainful,insulting,scornful]

contend=[#sad,#scared,compete,be_engaged_in_a_fight,fighter,repel,battle]

contort=[#sad,#angry,contortion,twisted,deformation,distort_shape,twist]

contradict=[#sad,#disgusting,disagree,be_in_contradiction_with,deny_the_truth_of,deviate,negation]

corrosive=[#sad,#scared,compound,spitefully_sarcastic,caustic,erosive,vitriolic]

craftily=[#sad,#scared,artful,crafty,disingenuous,cunning,dodgy]

crafty=[#sad,#scared,dodger,glibness,craft,rascality,trick]

creak=[#sad,#disgusting,noise,a_squeaking_sound,creaking,whine,squeak]

credulous=[#sad,#scared,credible,incredulous,credulousness,credulity,tendency_to_believe_too_readily_and_therefore_to_be_easily_deceived]

damnation=[#sad,#scared,the_state_of_being_condemned_to_eternal_punishment_in_hell,the_act_of_damning,denunciation,state,computer_game]

dangerousness=[#sad,#scared,the_quality_of_not_being_safe,characteristic,feature,device_characteristic,lineament]

darken=[#sad,#angry,become_dark_or_darker,blacken,change,tarnish,make_dark_or_darker]

deadlock=[#sad,#scared,situation,single_broadcast_tv_show,dead_end,impasse,stalemate]

debaser=[#sad,#scared,person,a_person_who_lowers_the_quality_or_character_or_value,alternative_rock,indie_rock,musical_work]

debilitate=[#sad,#angry,debilitative,drain,enfeeble,enervating,enfeebling]

decadent=[#sad,#scared,bad_person,marked_by_excessive_self_indulgence_and_moral_decay,a_person_who_has_fallen_into_a_decadent_state,degeneracy,self_indulgent]

deceptive=[#sad,#scared,deceive,be_false_to,cause_someone_to_believe_an_untruth,deceptiveness,designed_to_deceive_or_mislead_either_deliberately_or_inadvertently]

deceptively=[#sad,#scared,deceptive,designed_to_deceive_or_mislead_either_deliberately_or_inadvertently,delusory,misleading,shoddy]

decrepit=[#sad,#scared,infirmity,weakness,frailty,debility,feebleness]

decrepitude=[#sad,#scared,deterioration,dilapidation,impairment,decline_in_quality,declension]

defiance=[#sad,#scared,challenge,resistance,intentionally_contemptuous_behavior_or_attitude,intractability,a_defiant_act]

defile=[#sad,#scared,mar,cloud,pass,March,Mar]

deform=[#sad,#disgusting,change_shape,distortion,deformation,alteration_in_the_shape_or_dimensions_of_an_object_as_a_result_of_the_application_of_stress_to_it,shape]

defunct=[#sad,#scared,extinction,no_longer_in_existence,no_longer_in_force_or_use,zombie_process,defunctness]

dehumanization=[#sad,#scared,degradation,hardcore_punk,musical_work,anarcho_punk,dehumanisation]

delinquency=[#sad,#scared,law,nonpayment,negligence,misbehavior,jurisprudence]

delirious=[#sad,#scared,craze,state_of_violent_mental_agitation,experiencing_delirium,madness,marked_by_uncontrolled_excitement_or_emotion]

demonic=[#sad,#scared,monster,extremely_evil_or_cruel,unholiness,giant,goliath]

demonize=[#sad,#scared,change,demonization,devil,monster,musical_work]

denounce=[#sad,#angry,inform,informer,denunciation,announce,impart_knowledge_of_some_fact_state_or_affairs_or_event_to]

deplete=[#sad,#angry,lowness,consume,eat_up,use_up,eat]

deprecate=[#sad,#angry,disparagement,express_strong_disapproval_of,deprecation,the_act_of_expressing_disapproval,detractor]

derision=[#sad,#scared,contemptuous_laughter,the_act_of_deriding_or_treating_with_contempt,discourtesy,disrespect,ridicule]

derisive=[#sad,#scared,abusing_vocally,deride,gibelike,jeering,mocking]

desecrate=[#sad,#scared,treated_with_contempt,change_by_reversal,deconsecrate,profanation,assail]

desertion=[#sad,#scared,withdrawal,withdrawing_support_or_help_despite_allegiance_or_responsibility,abandonment,defection,forsaking]

despicable=[#sad,#scared,unworthiness,nefariousness,morally_reprehensible,baseness,loathsomeness]

destitute=[#sad,#scared,necessity,indigence,privation,essential,requirement]

deter=[#sad,#disgusting,disapprove,hindrance,deterrence,discouragement,discourage]

detraction=[#sad,#scared,disparagement,a_communication_that_belittles_somebody_or_something,depreciation,derogation,dispraise]

devastate=[#sad,#scared,overwhelm,devastation,overpower,sweep_over,whelm]

devilish=[#sad,#scared,playful_in_an_appealingly_bold_way,prankishness,mephistopheles,imp,hellion]

devious=[#sad,#scared,deceptiveness,deviating_from_a_straight_course,indirect_in_departing_from_the_accepted_or_proper_way,crookedness,characterized_by_insincerity_or_deceit]

diabolically=[#sad,#scared,demonic,devilish,diabolic,diabolical,fiendish]

ding=[#sad,#angry,ring,sound,ding_dong,halo,annulus]

dinky=[#sad,#scared,colloquialism,small_and_insignificant,a_colloquial_expression,locomotive,unite_kingdom]

disadvantageous=[#sad,#scared,constituting_a_disadvantage,disadvantage,minus,disfavor,disfavour]

disagreeably=[#sad,#scared,disagreeable,unsympathetic,unappealing,unlikeable,unlikable]

disapprobation=[#sad,#scared,an_expression_of_strong_disapproval,disapproval,condemnation,disfavor,disfavour]

disavow=[#sad,#angry,refuse_to_acknowledge,disavowal,deny,disclaimer,refuse]

disavowal=[#sad,#scared,denial_of_any_connection_with_or_knowledge_of,denial,disclaimer,disaffirmation,abnegation]

disclaim=[#sad,#angry,foreswear,claim,deny,disclaimer,a_voluntary_repudiation_of_a_person's_legal_claim_to_something]

discontinuity=[#sad,#scared,lack_of_connection_or_continuity,separation,continuity,breakup,detachment]

discontinuous=[#sad,#scared,mathematics,disjunct,discontinuity,disrupt,lack_of_connection_or_continuity]

discordance=[#sad,#scared,dissonance,identical_twin,disagreement,dissension,noise]

discountenance=[#sad,#scared,shame,disapprove,disgrace,ignominy,pity]

discouragingly=[#sad,#scared,discourage,deter,warn,admonish,monish]

discriminate=[#sad,#angry,undiscriminating,treat_differently_on_the_basis_of_sex_or_race,spot,discrimination,differentiator]

disdainful=[#sad,#scared,condescension,imperiousness,having_or_showing_arrogant_superiority_to_and_disdain_of_those_one_views_as_unworthy,arrogance,superciliousness]

disdainfully=[#sad,#scared,disdainful,cavalier,contemptuous,insulting,scornful]

disfavor=[#sad,#scared,inclination,the_state_of_being_out_of_favor,an_inclination_to_withhold_approval_from_some_person_or_group,rejection,disposition]

dishearten=[#sad,#scared,discourage,disheartenment,discouragement,take_away_the_enthusiasm_of,down_in_dump]

dishonestly=[#sad,#scared,corruptible,ambidextrous,dishonest,bribable,purchasable]

disingenuous=[#sad,#scared,distort,artfulness,disingenuousness,not_straightforward_or_candid,falsify]

disintegrate=[#sad,#angry,physic,change_integrity,integrate,break_into_parts_or_components_or_lose_cohesion_or_unity,change]

disintegration=[#sad,#scared,disability,musical_composition,disablement,handicap,impairment]

disinterest=[#sad,#scared,tolerance,musical_work,art_rock,indie_rock,neutrality]

dismally=[#sad,#scared,blue,atrocious,blueness,blue_sky,blue_air]

disobedience=[#sad,#scared,conformity,the_failure_to_obey,the_trait_of_being_unwilling_to_obey,insubordination,intractability]

disparagingly=[#sad,#scared,derogative,belittle,derogatory,disparaging,minimize]

dispensable=[#sad,#scared,indispensable,dispensability,de_novo,essential,dispensableness]

disrepute=[#sad,#scared,the_state_of_being_held_in_low_esteem,dishonor,discredit,dishonour,disgrace]

disruptive=[#sad,#scared,disrupt,riot,characterized_by_unrest_or_disorder_or_insubordination,tumult,turbulence]

dissatisfy=[#sad,#disgusting,fail_to_satisfy,dissatisfaction,displease,disappoint,let_down]

dissent=[#sad,#angry,act_of_dissent,the_difference_of_one_judge's_opinion_from_that_of_the_majority,law,disagreement,withhold_assent]

disservice=[#sad,#scared,injury,ill_service,ill_turn,hurt,harm]

dissidence=[#sad,#scared,disagreement,disagreement,dissension,dissonance,discrepancy]

dissolution=[#sad,#scared,separation_into_component_parts,natural_process,the_termination_or_disintegration_of_a_relationship,termination,disintegration]

dissonance=[#sad,#scared,disagreeable_sounds,sound_property,disagreement,dissension,noise]

dissuade=[#sad,#scared,determent,turn_away_from_by_persuasion,rede,dissuasion,persuading_not_to_do_or_believe_something]

dissuasive=[#sad,#scared,dissuade,admonitory,discourage,deter,cautionary]

distort=[#sad,#angry,musical_work,transmit_inaccurately,falsify,garble,warp]

divergent=[#sad,#scared,diverge,discrepancy,deviate,extend_in_a_different_direction,diverging_from_another_or_from_a_standard]

dogmatic=[#sad,#scared,dogma,a_religious_doctrine_that_is_proclaimed_as_true_without_proof,a_doctrine_or_code_of_beliefs_accepted_as_authoritative,characterized_by_assertion_of_unproved_or_unprovable_principles,tenet]

doldrums=[#sad,#scared,wind,alternative_rock,musical_work,psychedelic_pop,low_fidelity]

domineer=[#sad,#scared,blustery,submissive,imperiousness,authoritarian,cavalier]

doom=[#sad,#disgusting,guarantee,people_who_are_destined_to_die_soon,marked_by_or_promising_bad_fortune,destiny,determined_by_tragic_fate]

doomsday=[#sad,#scared,judgement_day,single_broadcast_tv_show,end_time,cartoon_character,doomsday_weapon]

dope=[#sad,#disgusting,under_the_influence_of_narcotics,pot,street_names_for_marijuana,change,drug]

doubtful=[#sad,#scared,doubt,unsettled_in_mind_or_opinion,fraught_with_uncertainty_or_doubt,open_to_doubt_or_suspicion,the_state_of_being_unsure_of_something]

downhill=[#sad,#scared,ski_race,descent,origin,extraction,line_of_descent]

downturn=[#sad,#scared,worsen,economic_downturn,decline,aggravate,exacerbate]

draconian=[#sad,#scared,draco,athenian_lawmaker_whose_code_of_laws_prescribed_death_for_almost_every_offense,Draco,Dragon,genus_Draco]

dragoon=[#sad,#scared,coerce,subjugate,cavalryman,hale,squeeze]

drawback=[#sad,#scared,disadvantage,take_away,disfavor,disfavour,dislike]

dripping=[#sad,#disgusting,edible_fat,drippage,drip,dribble,drop]

droop=[#sad,#angry,dangle,sag,a_shape_that_sags,weak_from_exhaustion,hanging_down]

dubious=[#sad,#scared,doubt,uncertainty,incertitude,dubiety,doubtfulness]

dungeon=[#sad,#scared,cell,underground_cell_or_labyrinth,electric_cell,cadre,cellular_telephone]

eccentricity=[#sad,#scared,circularity,geometry,ratio,a_ratio_describing_the_shape_of_a_conic_section,a_circularity_that_has_a_different_center_or_deviates_from_a_circular_path]

effigy=[#sad,#scared,representation,a_representation_of_a_person,fictitious_character,cartoon_character,image]

egocentric=[#sad,#scared,egoism,selfish_person,self_center,egocentrism,self-interest]

egomania=[#sad,#scared,mania,self_importance,musical_work,passion,cacoethes]

egotistically=[#sad,#scared,selfish,unselfishly,egotistic,egotistical,narcissistic]

embroil=[#sad,#disgusting,imbroglio,involve,deeply_involved_especially_in_something_complicated,embroilment,tangle]

emphatic=[#sad,#scared,stress,force,exclaim,the_relative_prominence_of_a_syllable_or_musical_note,emphasis]

encroach=[#sad,#scared,violation,intrude_on,advance,trespass,invader]

enfeeble=[#sad,#scared,infirmity,make_weak,debilitation,weaken,frailty]

enjoin=[#sad,#disgusting,injunction,forbid,enjoining,enjoinment,cease_and_desist_order]

enrage=[#sad,#scared,rage,infuriation,anger,fury,madness]

enslave=[#sad,#disgusting,subjugate,enslavement,repress,quash,keep_down]

entangle=[#sad,#angry,web,disentangle,tangle,something_jumbled_or_confused,involve]

entrapment=[#sad,#scared,defense,law,law_enforcement,defence,defensive_measure]

erratic=[#sad,#scared,liable_to_sudden_unpredictable_change,faithlessness,likely_to_perform_unpredictably,having_no_fixed_course,fickle]

erratically=[#sad,#scared,erratic,unpredictable,fickle,mercurial,quicksilver]

erroneous=[#sad,#scared,erroneousness,containing_or_characterized_by_error,error,mistake,fault]

escapade=[#sad,#scared,any_carefree_episode,diversion,risky_venture,dance_pop,pop_music]

evade=[#sad,#angry,get_off,act,hedge,fudge,put_off]

evasive=[#sad,#scared,evade,deliberately_vague_or_ambiguous,equivocation,hedge,fudge]

exaggeration=[#sad,#scared,understatement,misrepresentation,increase,making_to_seem_more_important_than_it_really_is,the_act_of_making_something_more_noticeable_than_usual]

exploitation=[#sad,#scared,an_act_that_exploits_or_victimizes_someone,the_act_of_making_some_area_of_land_or_water_more_profitable_or_productive_or_useful,use,mistreatment,not_good]

exterminate=[#sad,#scared,exterminator,kill,stamp_out,terminator,eradicator]

extort=[#sad,#scared,overcharge,swindler,obtain_through_intimidation,obtain,crime]

extravagance=[#sad,#scared,excessive_spending,improvidence,excess,the_trait_of_spending_extravagantly,waste]

extravagantly=[#sad,#scared,lavish,extravagant,shower,munificent,overgenerous]

fabrication=[#sad,#scared,a_deliberately_false_or_improbable_account,falsehood,dismantle,the_act_of_making_something_from_raw_materials,writing_in_a_fictional_form]

facetiously=[#sad,#scared,jest,banter,joke,gag,laugh]

faithless=[#sad,#scared,faithlessness,treason,infidelity,a_crime_that_undermines_the_offender's_government,having_the_character_of_or_characteristic_of_a_traitor]

fallacious=[#sad,#scared,fallaciousness,result_of_a_fallacy_or_error_in_reasoning,fallacy,unsoundness,based_on_an_incorrect_or_misleading_notion_or_information]

falsely=[#sad,#scared,false,deliberately_deceptive,incorrect,mistaken,delusive]

farce=[#sad,#disgusting,forcemeat,stuff,comedy,a_comedy_characterized_by_broad_satire_and_improbable_situations,fill]

farcical=[#sad,#scared,absurdity,broadly_or_extravagantly_humorous,farce,ridicule,absurdness]

fascist=[#sad,#scared,fascism,an_adherent_of_fascism_or_other_right_wing_authoritarian_views,a_political_theory_advocating_an_authoritarian_hierarchical_government,rightist,fascistic]

feckless=[#sad,#scared,unsuitability,generally_incompetent_and_ineffectual,fecklessness,worthlessness_due_to_being_feeble_and_ineffectual,not_fit_to_assume_responsibility]

figurehead=[#sad,#scared,figure,front_man,fig,human_body,physical_body]

flabbergast=[#sad,#scared,surprise,take_aback,surprisal,storm,violent_storm]

flake=[#sad,#disgusting,cover,form,screen,covert,concealment]

flaky=[#sad,#scared,flakiness,bite,a_small_fragment_of_something_broken_off_from_the_whole,craziness,daftness]

flaunt=[#sad,#disgusting,exhibitionist,ostentation,expose,the_act_of_displaying_something_ostentatiously,a_gaudy_outward_display]

flounder=[#sad,#disgusting,bottom_of_sea,flatfish,fight,any_of_several_families_of_fishes_having_flattened_bodies_that_swim_along_the_sea_floor_on_one_side_of_the_body_with_both_eyes_on_the_upper_side,flesh_of_any_of_various_american_and_european_flatfish]

foolhardy=[#sad,#scared,head,recklessness,harum_scarum,heady,rash]

foolishly=[#sad,#scared,foolish,unwisely,anserine,dopy,dopey]

fractious=[#sad,#scared,unruliness,refractoriness,unpredictably_difficult_in_operation,stubbornly_resistant_to_authority_or_control,refractory]

frantic=[#sad,#scared,excessively_agitated,frenetic,phrenetic,frenzied,delirious]

frazzle=[#sad,#angry,colloquialism,exhaust,exhaustion,fray,exhaust_fumes]

freakish=[#sad,#scared,abnormality,musical_work,abnormalcy,mental_defectiveness,freakishness]

frenzied=[#sad,#scared,mania,a_mood_disorder,manic,frantic,frenetic]

fret=[#sad,#scared,handicraft,architectural_ornament,an_ornamental_pattern_consisting_of_repeated_vertical_and_horizontal_lines,decorate,agitation_resulting_from_active_worry]

fugitive=[#sad,#scared,someone_who_is_sought_by_law_officers,person,someone_who_flees_from_an_uncongenial_situation,tv_show,criminal]

fulminate=[#sad,#angry,denounce,fulmination,appear,salt,a_salt_or_ester_of_fulminic_acid]

fundamentalism=[#sad,#scared,protestantism,the_interpretation_of_every_word_in_the_sacred_texts_as_literal_truth,load_with_mind_control,anti_modernist_movement_of_various_religion,mind_virus]

funky=[#sad,#scared,jazz,funk,stylish_and_modern_in_an_unconventional_way,having_the_soulful_feeling_of_early_blues,african_american]

furor=[#sad,#scared,disturbance,topic_category,perturbation,upset,disruption]

fusty=[#sad,#scared,stale_and_unclean_smelling,mustiness,old_fashion,musty,frowsty]

gaff=[#sad,#scared,spike,hook,fish_gear,spar,sail_vessel]

gangster=[#sad,#scared,syndicate,a_criminal_who_is_a_member_of_gang,criminal,gang,an_association_of_criminals]

gauche=[#sad,#scared,awkwardness,crudeness,lacking_social_polish,social_grace,torsion_angle]

gaudy=[#sad,#scared,unite_kingdom,banquet,feast,spread,junket]

gawky=[#sad,#scared,lout,awkwardness,gawkiness,lacking_grace_in_movement_or_posture,clumsy]

geezer=[#sad,#scared,man,colloquialism,fee_bird_in_park,mostly_50_plus,adult_male]

ghastly=[#sad,#scared,shockingly_repellent,ghastliness,grim,grisly,gruesome]

glib=[#sad,#scared,marked_by_lack_of_intellectual_depth,glibness,a_kind_of_fluent_easy_superficiality,artfully_persuasive_in_speech,having_only_superficial_plausibility]

glower=[#sad,#disgusting,stare,glare,gaze,blaze,brilliance]

goad=[#sad,#scared,a_verbalization_that_encourages_you_to_attempt_something,encouragement,prod,stab,urge_on]

graceless=[#sad,#scared,gracelessness,awkwardness,unpleasingness,lacking_grace,lacking_graciousness]

gracelessly=[#sad,#scared,graceless,unpleasing,ungraceful,gauche,unpolished]

grapple=[#sad,#scared,wrestle,wrestler,clasp,seize,the_act_of_engaging_in_close_hand_to_hand_combat]

grate=[#sad,#scared,grind,barrier,rub,harshness,scrape]

gravely=[#sad,#scared,grave,sedate,tomb,grave_accent,sculpt]

grotesque=[#sad,#scared,art,grotesqueness,distorted_and_unnatural_in_shape_or_size,freak,monster]

grudgingly=[#sad,#scared,ungrudgingly,grudge,score,grievance,stew]

grumble=[#sad,#disgusting,growler,growl,rumble,a_complaint_uttered_in_a_low_and_indistinct_tone,complaint]

haggard=[#sad,#scared,writer,tv_show,technical_death_metal,symphonic_metal,television_show]

haggle=[#sad,#angry,huckster,an_instance_of_intense_argument,wrangle,dicker,bargain]

haphazard=[#sad,#scared,dependent_upon_or_characterized_by_chance,randomness,carelessness,marked_by_great_carelessness,hit-or-miss]

hardball=[#sad,#scared,softball,attitude,baseball,tv_show,computer_game]

harden=[#sad,#angry,soft,the_process_of_becoming_hard_or_solid_by_cooling_or_drying_or_crystallization,sclerosis,make_hard_or_harder,become_hard_or_harder]

harpy=[#sad,#scared,harpia,mythical_monster,fruit_bat,greek_mythology,eagle]

harrow=[#sad,#angry,cultivator,plow,farm,a_cultivator_that_pulverizes_or_smooths_the_soil,disk]

hasty=[#sad,#scared,abruptness,precipitate,excessively_quick,haste,overly_eager_speed]

hatefulness=[#sad,#scared,the_quality_of_being_hateful,offensiveness,obnoxiousness,objectionableness,odiousness]

haunt=[#sad,#angry,preoccupy,tv_show,a_frequently_visited_place,ghost,area]

havoc=[#sad,#scared,disturbance,musical_performer,perturbation,upset,disruption]

heartbreaker=[#sad,#scared,charmer,defeat,musical_composition,music_single,musical_composition_song]

heckle=[#sad,#angry,interrupt,heckler,break,comb,make_fun_of]

heedless=[#sad,#scared,inattentiveness,heedlessness,marked_by_or_paying_little_heed_or_attention,careless,deaf]

hefty=[#sad,#scared,heft,brawny,muscular,powerful,sinewy]

hellion=[#sad,#scared,troublemaker,cartoon_character,fictitious_character,comic_character,speed_metal]

helplessly=[#sad,#scared,helpless,impotent,incapacitated,lost,disable]

heresy=[#sad,#scared,content,a_belief_that_rejects_the_orthodox_tenets_of_a_religion,message,subject_matter,substance]

heretic=[#sad,#scared,outcast,nonconformist,software_object,computer_game,castaway]

hiss=[#sad,#disgusting,boo,sibilant,a_cry_or_noise_made_to_express_displeasure_or_contempt,hisser,utter]

horde=[#sad,#scared,multitude,cartoon_character,fictitious_character,community,software_object]

hubris=[#sad,#scared,arrogance,lead_politician_to_make_bad_decision,haughtiness,hauteur,high-handedness]

hustler=[#sad,#scared,a_shrewd_or_unscrupulous_person_who_knows_how_to_circumvent_difficulties,colloquialism,opportunist,con_artist,tv_show]

hype=[#sad,#scared,car_show,publicize,tv_show,publicise,air]

ignoble=[#sad,#scared,base,ignobleness,not_of_the_nobility,currish,completely_lacking_nobility_in_character_or_quality_or_purpose]

illegally=[#sad,#scared,illegal,illegitimate,legitimately,lawful,bastard]

illegitimate=[#sad,#scared,criminal,illicitness,unlawful,base,leave_hand]

illicit=[#sad,#scared,adulterous,unlawful,contrary_to_accepted_morality_or_convention,illegitimate,outlaw]

illogically=[#sad,#scared,illogical,unlogical,confused,disconnected,disjointed]

imminence=[#sad,#scared,state,the_state_of_being_imminent_and_liable_to_happen_soon,imminency,imminentness,impendence]

immodest=[#sad,#scared,overweening,offending_against_sexual_mores_in_conduct_or_appearance,indecent,important,having_or_showing_an_exaggerated_opinion_of_your_importance_ability_etc]

immorally=[#sad,#scared,base,base_of_operations,foundation,fundament,foot]

impeach=[#sad,#disgusting,impeachment,charge,challenge,complaint,electric_charge]

imperfect=[#sad,#scared,not_perfect,blemish,defective,imperfection,break]

imperfectly=[#sad,#scared,imperfect,musical_work,folk_music,indie_rock,progressive]

imperialist=[#sad,#scared,imperialism,believer,a_policy_of_extending_your_rule_over_foreign_countries,truster,worshiper]

impersonal=[#sad,#scared,having_no_personal_preference,not_relating_to_or_responsive_to_individual_persons,disinterest,nonpersonal,neutral]

impertinent=[#sad,#scared,pertness,impertinence,characterized_by_a_lightly_pert_and_exuberant_quality,ill_mannered,perkiness]

impinge=[#sad,#scared,impingement,contact,trespass,encroachment,impact]

impious=[#sad,#scared,lacking_due_respect_or_dutifulness,godless,impiety,undutifulness,lacking_piety_or_reverence_for_a_god]

implicate=[#sad,#angry,involve,implication,an_accusation_that_brings_into_intimate_and_usually_incriminating_connection,affect,regard]

implication=[#sad,#scared,involvement,an_accusation_that_brings_into_intimate_and_usually_incriminating_connection,a_logical_relation_between_propositions_p_and_q_of_the_form_if_p_then_q,a_relation_implicated_by_virtue_of_involvement_or_close_connection,accusation]

implode=[#sad,#scared,explode,implosion,collapse,a_sudden_inward_collapse,industrial_music]

impolitely=[#sad,#scared,impolite,ill_mannered,discourteous,discourteously,rudely]

importune=[#sad,#angry,insistence,beg,the_act_of_insisting_on_something,insisting,imperativeness]

impossibly=[#sad,#scared,impossible,inconceivable,out_of_the_question,unimaginable,insufferable]

imprecise=[#sad,#scared,impreciseness,not_precise,general,imprecision,full_general]

improperly=[#sad,#scared,properly,improper,decently,decent,in_good_order]

impudence=[#sad,#scared,disrespect,an_impudent_statement,cheek,impertinence,crust]

impudent=[#sad,#scared,crust,insolence,Earth's_crust,incrustation,encrustation]

inaccuracy=[#sad,#scared,the_quality_of_being_inaccurate_and_having_errors,quality,caliber,calibre,character]

inadvisable=[#sad,#scared,not_advisable,inadvisability,the_quality_of_being_ill_advised,not_prudent_or_wise,unadvisable]

inappropriate=[#sad,#scared,improper,inappropriateness,unbefitting,not_suitable_for_a_particular_occasion_etc,inappropriate_conduct]

inappropriately=[#sad,#scared,inappropriate,unsuitably,incompatible,out_or_keeping,unfitting]

incitement=[#sad,#scared,something_that_incites_or_provokes,psychic_energy,incitation,provocation,exhortation]

incivility=[#sad,#scared,discourtesy,disrespect,rudeness,offense,offence]

inclement=[#sad,#scared,severity,severe,unsparing,bad_weather,badness]

incoherence=[#sad,#scared,lack_of_cohesion_or_clarity_or_organization,disjunction,coherence,nonsense_that_is_simply_incoherent_and_unintelligible,nonsense]

incompatibility=[#sad,#scared,the_quality_of_being_unable_to_exist_or_work_in_congenial_combination,the_degree_to_which_the_body's_immune_system_will_try_to_reject_foreign_material,the_relation_between_propositions_that_cannot_both_be_true_at_the_same_time,characteristic,physical_condition]

incompetence=[#sad,#scared,lack_of_physical_or_intellectual_ability_or_qualifications,disease,inability,inability_of_a_part_or_organ_to_function_properly,anger_customer]

incompetently=[#sad,#scared,incompetent,incompetent_person,unqualified,bungling,clumsy]

incomprehension=[#sad,#scared,inability,unfitness,softness,balminess,gentleness]

incongruous=[#sad,#scared,incongruity,inappropriate,inharmonious,ironic,discrepant]

inconsolable=[#sad,#scared,despondency,sad_beyond_comforting,desolate,musical_work,pop_rock]

incorrectly=[#sad,#scared,faulty,defective,incorrect,wrong,falsely]

incredulous=[#sad,#scared,disbelieve,incredulity,not_disposed_or_willing_to_believe,discredit,disbelief]

incredulously=[#sad,#scared,credulously,disbelieve,incredulous,believingly,discredit]

inculcate=[#sad,#angry,drill,inculcation,instill,infuse,Mandrillus_leucophaeus]

indecently=[#sad,#scared,indecent,indecorous,unbecoming,uncomely,unseemly]

indecorum=[#sad,#scared,impropriety,a_lack_of_decorum,improperness,indecency,familiarity]

indelicate=[#sad,#scared,verging_on_the_indecent,same_as_indecent,off-color,off-colour,indecorous]

indiscreetly=[#sad,#scared,discreet,discerning,circumspect,spot,recognize]

indiscretion=[#sad,#scared,misbehavior,folly,injudiciousness,peccadillo,misbehaviour]

indiscriminate=[#sad,#scared,not_marked_by_fine_distinctions,sweep,promiscuous,failing_to_make_or_recognize_distinctions,expanse]

indoctrinate=[#sad,#angry,teach_doctrines_to,teach,indoctrination,doctrine,one_side]

indoctrination=[#sad,#scared,teach,teaching_someone_to_accept_doctrines_uncritically,belief_system,educational_event,Teach]

indolent=[#sad,#scared,pathology,work_shy,faineant,lazy,otiose]

ineffectually=[#sad,#scared,futile,ineffectual,otiose,unavailing,bootless]

inefficient=[#sad,#scared,inefficiency,uneconomical,efficiency_level,ineffective,wasteful]

inefficiently=[#sad,#scared,ineffective,uneffective,ineffectual,unable,inefficient]

inelegant=[#sad,#scared,gauche,lacking_in_refinement_or_grace_or_good_taste,inelegance,homely,graceless]

ineptly=[#sad,#scared,feckless,awkward,inept,bunglesome,clumsy]

inequitable=[#sad,#scared,not_equitable_or_fair,injustice,unjust,unfairness,iniquity]

inevitably=[#sad,#scared,inevitable,necessary,necessity,essential,requirement]

inexcusably=[#sad,#scared,inexcusable,unpardonable,not_excusable,unpardonably,unforgivably]

inexperience=[#sad,#scared,ignorance,lack_of_experience_and_the_knowledge_and_understanding_derived_from_experience,rawness,incompleteness,tenderness]

inextricable=[#sad,#scared,unresolvable,not_permitting_extrication,insolvable,unsoluble,unsolvable]

infamy=[#sad,#scared,evil_fame_or_public_reputation,a_state_of_extreme_dishonor,dishonor,disrepute,opprobrium]

infest=[#sad,#disgusting,inhabit,invade,infestation,a_swarm_of_insects_that_attack_plants,populate]

infiltrator=[#sad,#scared,intruder,spy,someone_who_takes_up_a_position_surreptitiously_for_the_purpose_of_espionage,action_game,video_game]

inflammatory=[#sad,#scared,inflame,cause_inflammation_in,incendiary,incitive,instigative]

inflationary=[#sad,#scared,deflationary,economics,inflation,economic_science,political_economy]

inhibit=[#sad,#disgusting,inhibitor,restrain,restrict,uninhibited,chemistry]

inhospitality=[#sad,#scared,welcome,unkind_and_inconsiderate_welcome,receive,have,get]

iniquitous=[#sad,#scared,sin,ungodliness,evil,characterized_by_iniquity,musical_work]

inopportune=[#sad,#scared,ill_time,not_opportune,inopportuneness,inconvenient,untimeliness]

inordinately=[#sad,#scared,extraordinary,excessive,studiousness,over-the-top,sinful]

insanely=[#sad,#scared,sanely,brainsick,insane,sensibly,reasonably]

insidious=[#sad,#scared,insidiousness,perniciousness,intended_to_entrap,beguiling_but_harmful,the_quality_of_being_designed_to_entrap]

insidiously=[#sad,#scared,baneful,insidious,deadly,pernicious,pestilent]

insignificance=[#sad,#scared,unimportance,the_quality_of_having_little_or_no_significance,musical_work,indie_rock,humbleness]

insignificantly=[#sad,#scared,insignificant,not_worthy_of_notice,undistinguished,peanut,unimportant]

insincerity=[#sad,#scared,untruthfulness,the_quality_of_not_being_open_or_truthful,falseness,hollowness,falsity]

insinuation=[#sad,#scared,implication,deduction,entailment,significance,import]

insufficiently=[#sad,#scared,insufficient,deficient,lacking,wanting,inferior]

insular=[#sad,#scared,island,insulation,the_state_of_being_isolated_or_detached,suggestive_of_the_isolated_life_of_an_island,narrowly_restricted_in_outlook_or_scope]

inundate=[#sad,#disgusting,downpour,submergence,flood,the_rising_of_a_body_of_water_and_its_overflowing_onto_normally_dry_land,deluge]

invasive=[#sad,#scared,confine,noninvasive,medicine,invade,aggressive]

ironic=[#sad,#scared,irony,incongruity_between_what_might_be_expected_and_what_actually_occurs,music_single,musical_composition,sarcasm]

ironically=[#sad,#scared,make_musical_sound,dry,prohibitionist,dry_out,ironic]

irreconcilable=[#sad,#scared,inconsistent,hostile,discrepant,unreconcilable,uncongenial]

irresolute=[#sad,#scared,discourage,weak_kneed,irresoluteness,uncertain_how_to_act_or_proceed,unstable]

irreversible=[#sad,#scared,permanent,irreversibility,incapable_of_being_reversed,permanent_wave,perm]

jabber=[#sad,#angry,gibberish,rapid_and_indistinct_speech,jabbering,gabble,rant]

jitter=[#sad,#scared,nervousness,slang,noise,movement,a_small_irregular_movement]

judder=[#sad,#angry,unite_kingdom,vibrate,oscillate,hover,vacillate]

junkyard=[#sad,#scared,yard,container_underspecified,non_agent_like_place,open_area,artifact_type_by_function]

kook=[#sad,#scared,anomaly,musical_composition_song,radio_station,indie_rock,pop_rock]

lackluster=[#sad,#scared,flatness,lacking_brilliance_or_vitality,musical_performer,lacklustre,lusterless]

lambast=[#sad,#disgusting,make_allowance,chew_out,have_word,verständnis_zeigen,show_understand]

languish=[#sad,#disgusting,devolve,attenuation,languisher,fall,return]

lapse=[#sad,#scared,backslide,end,pause,forfeit,slip]

lascivious=[#sad,#scared,driven_by_lust,lecherousness,libido,prurience,cartoon_character]

laughably=[#sad,#scared,amuse,farcical,divert,disport,ludicrous]

lawless=[#sad,#scared,criminal,lawlessness,anarchic,anarchical,wide-open]

layoff=[#sad,#scared,lie_off,closure,lie_off,reduction_in_force,closing]

lecherous=[#sad,#scared,lechery,satyr,lecherousness,lecher,lech]

leery=[#sad,#scared,suspicion,misgive,openly_distrustful_and_unwilling_to_confide,sneer,wariness]

lewd=[#sad,#scared,obscenity,coarseness,lewdness,bawdiness,salaciousness]

lewdly=[#sad,#scared,lascivious,obscene,lewd,libidinous,lustful]

liable=[#sad,#scared,liability,subject_to_legal_action,held_legally_responsible,indebtedness,financial_obligation]

licentious=[#sad,#scared,licentiousness,license,profligacy,lacking_moral_discipline,wantonness]

licentiously=[#sad,#scared,easy,licentious,easygoing,leisurely,gentle]

licentiousness=[#sad,#scared,the_quality_of_being_lewd_and_lascivious,immorality,wantonness,profligacy,dissipation]

loath=[#sad,#scared,reluctance,unwillingness_to_do_something_contrary_to_your_custom,loth,reluctant,antipathetic]

lone=[#sad,#scared,characterized_by_or_preferring_solitude,aloneness,a_disposition_toward_being_alone,hermit,alone]

lugubrious=[#sad,#scared,gloominess,excessively_mournful,gloom,glumness,somberness]

lurid=[#sad,#scared,lividness,sensationalism,shining_with_an_unnatural_red_glow_as_of_fire_seen_through_smoke,ghastly_pale,unnatural_lack_of_color_in_the_skin]

lurk=[#sad,#scared,lurker,hide,hang_out,skulker,lurcher]

madden=[#sad,#scared,anger,craze,torment,choler,ire]

madly=[#sad,#scared,intensifier,delirious,frantic,intensive,hallucinating]

maladjusted=[#sad,#scared,unadapted,psychology,not_well_adjusted,alternative_rock,indie_rock]

malaise=[#sad,#scared,discomfort,confuse_pain,ill_at_ease,unease,uneasiness]

malignant=[#sad,#scared,pathology,malignancy,cancerous,dangerous_to_health,malignance]

maniacal=[#sad,#scared,lunatic,maniac,wildly_disordered,musical_work,crossover_thrash]

manipulation=[#sad,#scared,exerting_shrewd_or_devious_influence_especially_for_one's_own_advantage,influence,use,handling,act_upon]

manipulative=[#sad,#scared,manipulate,influence_or_control_shrewdly_or_deviously,skillful_in_influencing_or_controlling_others_to_your_own_advantage,pull_strings,pull_wires]

martyrdom=[#sad,#scared,death,calvary,decease,expiry,dying]

matte=[#sad,#scared,mixture,flatness,lusterlessness,lustrelessness,mat]

mawkishness=[#sad,#scared,falsely_emotional_in_a_maudlin_way,emotionality,sentimentality,bathos,drippiness]

measly=[#sad,#scared,paltriness,miserable,paltry,sorriness,suffering]

meddle=[#sad,#disgusting,meddler,change_of_state,intervene,have_sex,step_in]

mediocre=[#sad,#scared,second_rater,a_person_of_second_rate_ability_or_value,moderate_to_inferior_in_quality,second-rate,average]

meltdown=[#sad,#scared,overheat,calamity,china_syndrome,video_game,hard_rock]

mercilessly=[#sad,#scared,merciless,pitiless,unmerciful,remorseless,ruthless]

mindlessly=[#sad,#scared,mindless,requiring_little_mental_effort,unmindful,forgetful,asinine]

misalign=[#sad,#disgusting,misalignment,align,aline,line_up,adjust]

mischievous=[#sad,#scared,mischief,maleficence,arch,impish,implike]

misdirection=[#sad,#scared,direction,commission,way,guidance,counsel]

miser=[#sad,#scared,count_money,hoarder,a_stingy_hoarder_of_money_and_possessions,save_cent,save_money]

mismanage=[#sad,#disgusting,mismanagement,misconduct,manage,misdirection,wrongdoing]

mispronounce=[#sad,#scared,mispronunciation,pronounce,articulate,enounce,sound_out]

misread=[#sad,#disgusting,misinterpretation,misinterpretation_caused_by_inaccurate_reading,putting_the_wrong_interpretation_on,read,take]

misstatement=[#sad,#scared,a_statement_that_contains_a_mistake,statement,argument,affirmation,assertion]

mistakenly=[#sad,#scared,erroneous,false,mistaken,delusive,fake]

mistress=[#sad,#scared,an_adulterous_woman,lover,a_woman_master_who_directs_the_work_of_others,employer,woman]

molestation=[#sad,#scared,sexual_assault,harassment,torment,torture,anguish]

monstrous=[#sad,#scared,giant,freak,colossus,behemoth,heavyweight]

moody=[#sad,#scared,temperament,temper,moodiness,evangelist,tennis_player]

moot=[#sad,#angry,law,moot_court,the_collection_of_rules_imposed_by_authority,lawsuit,public_house]

moronic=[#sad,#scared,idiot,imbecile,cretin,moron,changeling]

mushy=[#sad,#scared,mush,mushiness,pulp,mushy_pea,cornmeal_mush]

nastily=[#sad,#scared,hateful,nasty,mean,awful,tight]

nefarious=[#sad,#scared,villain,villainy,nefariousness,extremely_wicked,scoundrel]

negativity=[#sad,#scared,characterized_by_habitual_skepticism_and_a_disagreeable_tendency_to_deny_or_oppose_or_resist_suggestions_or_commands,amount,quality,the_character_of_the_negative_electric_pole,an_amount_less_than_zero]

nemesis=[#sad,#scared,greek_deity,greek_mythology,computer_game,cartoon_character,fictitious_character]

nervously=[#sad,#scared,skittish,nervous,flighty,spooky,anxious]

nitpick=[#sad,#scared,nitpicker,knock,split_hair,knocking,roast]

objection=[#sad,#scared,the_speech_act_of_objecting,law,a_procedure_whereby_a_party_to_a_suit_says_that_a_particular_line_of_questioning_or_a_particular_witness_or_a_piece_of_evidence_or_other_matter_is_improper_and_should_not_be_continued_and_asks_the_court_to_rule_on_its_impropriety_or_illegality,procedure,speech_act]

objectionable=[#sad,#scared,hatefulness,causing_disapproval_or_protest,obnoxiousness,objectionableness,obnoxious]

obliterate=[#sad,#disgusting,annihilation,extinguish,eradication,obscure,blur]

oblivious=[#sad,#scared,unmindfulness,obliviousness,oblivious_transfer,musical_work,television_show]

obscurity=[#sad,#scared,an_obscure_and_unimportant_standing,stand,semidarkness,obscureness,abstruseness]

obsess=[#sad,#angry,worry,obsession,influenced_or_controlled_by_a_powerful_force_such_as_a_strong_emotion,concern,headache]

obtrusive=[#sad,#scared,push_out,obtrusiveness,unobtrusive,obviousness,undesirably_noticeable]

obtuse=[#sad,#scared,obtuseness,lacking_in_insight_or_discernment,dullness,rounded_at_the_apex,quick_off_mark]

occlude=[#sad,#scared,taken_into_and_retained_in_another_substance,obstruct,obturate,impede,jam]

offensively=[#sad,#scared,in_an_unpleasantly_offensive_manner,objectionable,offensive,unpleasant_or_disgusting_especially_to_the_senses,causing_anger_or_annoyance]

omission=[#sad,#scared,any_process_whereby_sounds_or_words_are_left_out_of_spoken_words_or_phrases,mistake,a_mistake_resulting_from_neglect,neglecting_to_do_something,linguistic_process]

onslaught=[#sad,#scared,trouble,physically_attack_agent,cartoon_character,computer_game,fictitious_character]

opinionated=[#sad,#scared,opine,opinionative,self-opinionated,speak_up,speak_out]

ordeal=[#sad,#scared,experience,trial,trial_by_fire,see,go_through]

ostracize=[#sad,#disgusting,banishment,avoid,exclude,ostracism,silent_treatment]

outcast=[#sad,#scared,a_person_who_is_rejected,unfortunate,tv_show,software_object,computer_game]

outrageously=[#sad,#scared,exorbitant,hideous,extortionate,outrageous,steep]

overact=[#sad,#disgusting,ham,act,dramaturgy,underact,an_unskilled_actor_who_overacts]

overawe=[#sad,#scared,coward,awe,subdue_restrain_or_overcome_by_affecting_with_a_feeling_of_awe,cow,Coward]

overdo=[#sad,#disgusting,do_something_to_an_excessive_degree,cooked_too_long_but_still_edible,exaggeration,make,exaggerate]

overheat=[#sad,#angry,excessive_heating,heat,get_excessively_and_undesirably_hot,make_hot_or_hotter,gain_heat_or_get_hot]

overkill=[#sad,#scared,effort,capability,computer_game,software_object,single_broadcast_tv_show]

overreach=[#sad,#angry,fail,get_good_of,neglect,go_wrong,miscarry]

overrun=[#sad,#disgusting,overshoot,get_good_of,fnance_and_economy,wave-off,go-around]

overshadow=[#sad,#scared,obscure,brood,dominate,eclipse,shadow]

oversight=[#sad,#scared,mistake,omission,error,fault,misunderstanding]

oversimplify=[#sad,#scared,overdo,oversimplification,an_act_of_excessive_simplification,simplify,exaggerate]

overwhelmingly=[#sad,#scared,overpower,irresistible,overmaster,overwhelm,sweep_over]

pander=[#sad,#angry,pimp,provide,procurer,panderer,pandar]

paradoxical=[#sad,#scared,paradox,seemingly_contradictory_but_nonetheless_possibly_true,self_contradictory,self_evident,self-contradictory]

pariah=[#sad,#scared,cartoon_character,software_object,fictitious_character,computer_game,fictional_character]

parody=[#sad,#angry,a_composition_that_imitates_or_misrepresents_somebody's_style_usually_in_a_humorous_way,apery,humorous_or_satirical_mimicry,caricature,act]

pathetically=[#sad,#scared,hapless,pathetic,miserable,misfortunate,piteous]

patronize=[#sad,#scared,patron,trade,foster,do_one's_shopping_at,condescension]

peeve=[#sad,#scared,temper,annoy,pet_peeve,pique,irritation]

peevishly=[#sad,#scared,fretful,cranky,antsy,fidgety,itchy]

perilously=[#sad,#scared,parlous,dangerous,hazardous,perilous,precarious]

persecute=[#sad,#disgusting,torment,oppressor,cause_to_suffer,persecution,tormentor]

persecution=[#sad,#scared,the_act_of_persecuting,maltreatment,religion,action_on_object,unnatural_thing]

perverse=[#sad,#scared,contrariness,perversity,perverseness,crankiness,crotchetiness]

perversely=[#sad,#scared,deprave,contrary,corrupt,pervert,subvert]

petrify=[#sad,#angry,deaden,lapidify,rigidify,ossify,dampen]

pig=[#sad,#angry,find_truffle,farm_animal,smart_animal,curly_tail,hog]

pillory=[#sad,#scared,instrument_of_punishment,punish,expose,penalize,penalise]

plagiarize=[#sad,#disgusting,steal,plagiarism,plagiarist,the_act_of_plagiarizing,crime]

plaything=[#sad,#scared,an_artifact_designed_to_be_played_with,artifact,toy,artefact,miniature]

plebeian=[#sad,#scared,common,folk,one_of_the_common_people,park,commons]

ploy=[#sad,#scared,maneuver,write_information,manoeuvre,simulated_military_operation,tactic]

plunder=[#sad,#scared,spoil,the_act_of_stealing_valuable_things_from_a_place,loot,steal_goods,aggression]

plunderer=[#sad,#scared,war,someone_who_takes_spoils_or_plunder,thief,cartoon_character,fictitious_character]

polemize=[#sad,#angry,quarrel,polemic,wrangle,row,words]

pollute=[#sad,#angry,pollutant,polluter,pollution,make_impure,contamination]

polluter=[#sad,#scared,bad_person,a_person_or_organization_that_causes_pollution_of_the_environment,person_or_company_that_cause_pollution,borrow_environment_from_their_child,defiler]

pompous=[#sad,#scared,pomp,ceremony,ceremonial_elegance_and_splendor,self_efface,gaudery]

precarious=[#sad,#scared,instability,uncertainty,being_unsettled_or_in_doubt_or_dependent_on_chance,affording_no_ease_or_reassurance,shakiness]

precipitate=[#sad,#disgusting,precipitator,precipitation,the_falling_to_earth_of_any_form_of_water,the_act_of_casting_down_or_falling_headlong_from_a_height,precipitant]

predatory=[#sad,#scared,vulture,bird_of_prey,marauder,predator,piranha]

prejudge=[#sad,#disgusting,prejudgment,evaluate,prejudgement,measure,valuate]

prejudicial=[#sad,#scared,bias,a_partiality_that_prevents_objective_consideration_of_an_issue_or_situation,prejudice,preconception,diagonal]

preoccupy=[#sad,#disgusting,preoccupancy,engage_or_engross_the_interest_or_attention_of_beforehand_or_occupy_urgently_or_obsessively,preoccupation,the_mental_state_of_being_preoccupied_by_something,control]

propaganda=[#sad,#scared,information,information_that_is_spread_for_the_purpose_of_promoting_some_cause,write_or_speak_work,info,data]

propagandize=[#sad,#scared,advertise,propaganda,information_that_is_spread_for_the_purpose_of_promoting_some_cause,tell,publicize]

proprietary=[#sad,#scared,trademark,owner,patent,copyright,brand]

prosecute=[#sad,#disgusting,prosecution,prosecutor,engagement,pastime,a_government_official_who_conducts_criminal_prosecutions_on_behalf_of_the_state]

provocation=[#sad,#scared,needed_encouragement,encouragement,become_angry,aggravation,irritation]

pugnacious=[#sad,#scared,rowdiness,ready_and_able_to_resort_to_force_or_violence,hard-bitten,hard-boiled,rough]

puny=[#sad,#scared,pettiness,of_inferior_size,puniness,inferior_in_strength_or_significance,runt]

puppet=[#sad,#scared,doll,figure,a_doll_with_a_hollow_head_of_a_person_or_animal_and_a_cloth_body,doll_that_you_put_your_hand_in_make_it_move,non_agentive_artifact]

questionable=[#sad,#scared,equivocal,self_style,apocryphal,impugnable,unquestionable]

quibble=[#sad,#scared,carper,evasion,quibbler,argue,hedge]

quitter=[#sad,#scared,person,a_person_who_gives_up_too_easily,throw_in_towel,individual,someone]

racy=[#sad,#scared,race,subspecies,slipstream,airstream,backwash]

rampage=[#sad,#angry,act_violently_recklessly_or_destructively,violently_angry_and_destructive_behavior,disturbance,act,single_broadcast_tv_show]

rampant=[#sad,#scared,ramp,unrestrained_and_violent,heraldry,be_rampant,having_a_lush_and_unchecked_growth]

randomly=[#sad,#scared,haphazard,random,indiscriminate,hit-or-miss,slapdash]

ravage=[#sad,#angry,ruinously_destructive_and_wasting,plural,plunder,plundering_with_excessive_damage_and_destruction,a_destructive_action]

reactionary=[#sad,#scared,reaction,an_extreme_conservative,conservative,extremely_conservative,chemical_reaction]

recession=[#sad,#scared,cession,the_withdrawal_of_the_clergy_and_choir_from_the_chancel_to_the_vestry_at_the_end_of_a_church_service,the_state_of_the_economy_declines,economic_condition,procession]

recoil=[#sad,#disgusting,a_movement_back_from_an_impact,movement,the_backward_jerk_of_a_gun_when_it_is_fired,a_natural_event_that_involves_a_change_in_the_position_or_location_of_something,single_broadcast_tv_show]

redundancy=[#sad,#scared,the_attribute_of_being_superfluous_and_unneeded,a_system_design_that_duplicates_components_to_provide_alternatives_in_case_one_component_fails,configuration,repetition_of_an_act_needlessly,electronics]

refusal=[#sad,#scared,the_act_of_refusing,a_message_refusing_to_accept_something_that_is_offered,denial,message,disaffirmation]

refutation=[#sad,#scared,answer,the_speech_act_of_answering_an_attack_on_your_assertions,reply,response,solution]

regressive=[#sad,#scared,tax,unmodernized,regress,atavistic,retrograde]

regretfully=[#sad,#scared,regretful,sad_to_say,sorry,bad,deplorable]

relapse=[#sad,#disgusting,recidivism,revert,backslide,return,retrovert]

relentlessness=[#sad,#scared,mercilessness,mercilessness_characterized_by_an_unwillingness_to_relent_or_let_up,inexorability,inexorableness,cruelty]

reluctant=[#sad,#scared,reluctance,not_eager,a_certain_degree_of_unwillingness,loath,loth]

renunciation=[#sad,#scared,the_act_of_renouncing,an_act_declaring_that_something_is_surrendered_or_disowned,resignation,rejection,loss_of_membership_in_organization]

reprehensibly=[#sad,#scared,blameworthy,condemnable,blamable,blameable,blameful]

repression=[#sad,#scared,psychiatry,subjugation,control,defense_mechanism,a_state_of_forcible_subjugation]

repudiation=[#sad,#scared,rejecting_or_disowning_or_disclaiming_as_invalid,rejection,refusal,refusal_to_acknowledge_or_pay_a_debt_or_honor_a_contract,the_exposure_of_falseness_or_pretensions]

resent=[#sad,#scared,feel_bitter_or_indignant_about,resentment,dislike,give_forth,begrudge]

restrictive=[#sad,#scared,restrict,limit,unpermissiveness,confine,inhibitory]

resurgent=[#sad,#scared,rebirth,revival,resurge,metempsychosis,reincarnation]

retaliate=[#sad,#angry,strike,retaliation,fight_back,in_kind,musical_work]

reticent=[#sad,#scared,temperamentally_disinclined_to_talk,reserve,reluctant_to_draw_attention_to_yourself,tight_lipped,untalkative]

retract=[#sad,#disgusting,retractor,pull,pulling,clout,wrench]

revengeful=[#sad,#scared,vindictiveness,disposed_to_seek_revenge_or_intended_for_revenge,vengefulness,vindictive,vengeful]

revoke=[#sad,#disgusting,countermand,the_mistake_of_not_following_suit_when_able_to_do_so,cancel,abrogation,revocation]

rhapsodize=[#sad,#angry,rhapsody,enthuse,tell,Tell,William_Tell]

rhetorical=[#sad,#scared,flowery,bombastic,poetic,stylistic,rhetoric]

rift=[#sad,#scared,crack,open,cleft,crevice,fissure]

rocky=[#sad,#scared,rockiness,rock,liable_to_rock,abounding_in_rocks_or_stones,boulder]

rollercoaster=[rumor=[#sad,#angry,dish_dirt,gossip,write_or_speak_work,musical_composition,word_of_mouth]

rumple=[#sad,#angry,wrinkle,fold,furrow,crease,crinkle]

runaway=[#sad,#scared,victory,completely_out_of_control,tv_show,run_away,musical_composition_song]

rust=[#sad,#scared,rustless,any_of_various_fungi_causing_rust_disease_in_plants,the_formation_of_reddish_brown_ferric_oxides_on_iron_by_low_temperature_oxidation_in_the_presence_of_water,oxidise,a_plant_disease_that_produces_a_reddish_brown_discoloration_of_leaves_and_stems]

rusty=[#sad,#scared,rustiness,rust,out_of_practice,rust-brown,out_of_practice]

sabotage=[#sad,#scared,destruction,a_deliberate_act_of_destruction_or_disruption_in_which_equipment_is_damaged,disobey,destroy_property_or_hinder_normal_operations,computer_game]

sack=[#sad,#scared,plunderer,the_quantity_contained_in_a_sack,fabric,coarse_fabric_used_for_bags_or_sacks,a_bag_made_of_paper_or_plastic_for_holding_customer's_purchases]

sag=[#sad,#scared,droop_sink_or_settle_from_or_as_if_from_pressure_or_loss_of_tautness,a_shape_that_sags,depression,sink,fall_or_descend_to_a_lower_place_or_level]

sap=[#sad,#angry,solution,cave,sapper,a_watery_solution_of_sugars_salts_and_minerals_that_circulates_through_the_vascular_system_of_a_plant,wear_away]

sarcasm=[#sad,#scared,hurtful_to_others,witty_language_used_to_convey_insults_or_scorn,wit,sarcastic,jealousy_in_bold_disguise]

satirical=[#sad,#scared,sarcasm,exposing_human_folly_to_ridicule,satiric,irony,satire]

scam=[#sad,#disgusting,swindle,a_fraudulent_business_scheme,con_game,cozenage,victimize]

scant=[#sad,#angry,restrict,athletic_supporter,boxer_short,long_john,curtail]

scapegoat=[#sad,#scared,victim,whip_boy,shoulder_blame,stool_pigeon,dupe]

scathing=[#sad,#scared,vilify,marked_by_harshly_abusive_criticism,revile,vituperate,rail]

scathingly=[#sad,#scared,scathing,unsparing,vituperative,lavish,munificent]

scourge=[#sad,#scared,flogger,whip,punish,a_whip_used_to_inflict_punishment,scourger]

scowl=[#sad,#angry,frown,look_angry_or_sullen_wrinkle_one's_forehead_as_if_to_signal_disapproval,glower,lour,lower]

scramble=[#sad,#angry,patchwork,struggle,scrambler,electronic_equipment_that_makes_speech_unintelligible_during_transmission_and_restores_it_at_reception,scamper]

screech=[#sad,#scared,noise,a_high_pitched_noise_resembling_a_human_cry,cartoon_character,fictitious_character,dissonance]

scum=[#sad,#scared,film,get_rid_of,a_film_of_impurities_or_vegetation_that_can_form_on_the_surface_of_a_liquid,music_single,trash]

seedy=[#sad,#scared,multi_seed,white_seed,black_seed,single_seed,seed]

seethe=[#sad,#angry,be_in_an_agitated_emotional_state,in_constant_agitation,foam,be,churn]

sermonize=[#sad,#disgusting,sermon,an_address_of_a_religious_nature,preach,moralize,preachification]

servitude=[#sad,#scared,bondage,slavery,thrall,thralldom,thraldom]

shabby=[#sad,#scared,mean_and_unworthy_and_despicable,injustice,moth-eaten,ratty,tatty]

shady=[#sad,#scared,shadow,shade,darkness,dark,apparition]

shaky=[#sad,#scared,shake,vibrating_slightly_and_irregularly,rickety,wobbly,wonky]

shamefulness=[#sad,#scared,unworthiness_meriting_public_disgrace_and_dishonor,unworthiness,disgracefulness,ignominiousness,inappropriateness]

shamelessness=[#sad,#scared,boldness,behavior_marked_by_a_bold_defiance_of_the_proprieties_and_lack_of_shame,brazenness,daring,hardiness]

sharply=[#sad,#scared,crisp,acuate,sharp,chip,potato_chip]

shimmer=[#sad,#angry,a_weak_and_tremulous_light,glitter,shine,change,music_single]

shimmy=[#sad,#disgusting,vibrate,wobble,dance,social_dance,taking_a_series_of_rhythmical_steps_in_time_to_music]

shipwreck=[#sad,#disgusting,bottom_of_sea,ruin,water_travel,subject,destroy_or_cause_to_fail]

shirk=[#sad,#disgusting,evasion,avoid,the_evasion_of_work_or_duty,equivocation,nonpayment]

shock=[#disgusting,#scared,scandal,scandalization,an_unpleasant_or_disappointing_surprise,pathology,gather]

shortness=[#sad,#scared,the_property_of_being_of_short_temporal_extent,the_property_of_being_of_short_spatial_extent,lack,the_condition_of_being_short_of_something,the_property_of_being_shorter_than_average_stature]

showdown=[#sad,#scared,single_broadcast_tv_show,music_single,thrash_metal,progressive_rock,electronic_rock]

shrivel=[#sad,#angry,wither_as_with_a_loss_of_moisture,decrease,surface_area,lean_and_wrinkled_by_shrinkage_as_from_age_or_illness,reduced_in_efficacy_or_vitality_or_intensity]

shroud=[#sad,#disgusting,pall,burial_garment_in_which_a_corpse_is_wrapped,cover,wrap,line]

shun=[#sad,#angry,avoidance,avoid,turning_away,shunning,dodging]

sidetrack=[#sad,#angry,digression,straggler,deviate,straggle,train_of_think]

sinister=[#sad,#scared,heraldry,baleful,forbidding,menacing,minacious]

sketchy=[#sad,#scared,sketch,sketchiness,giving_only_major_points,television_episode,study]

skinny=[#sad,#scared,skin,a_natural_protective_body_covering_and_site_of_the_sense_of_touch,information,skinny_dip,tegument]

skittish=[#sad,#scared,unpredictably_excitable,nervousness,skittishness,musical_composition,flighty]

skulk=[#sad,#disgusting,walk,fictitious_character,cartoon_character,walking,base_on_balls]

sleazy=[#sad,#scared,musical_composition_song,musical_work,bum,cheap,cheesy]

slime=[#sad,#angry,sludge,any_thick_viscous_matter,dirty,sliminess,goo]

slog=[#sad,#scared,plod,trudge,trudger,walk,plodder]

sloppy=[#sad,#scared,sloppiness,lacking_neatness_or_order,wateriness,boggy,marshy]

slowly=[#sad,#scared,slow,colloquialism,decelerate,slow_down,slow_up]

sluggish=[#sad,#scared,sluggishness,moving_slowly,lethargy,lassitude,languor]

slur=[#sad,#scared,music,spoken_as_if_with_a_thick_tongue,play,aspersion,musical_notation]

smelt=[#sad,#disgusting,smelter,osmeridae,produce,small_cold_water_silvery_fish,soft_fin_fish]

smolder=[#sad,#scared,feel,smoulder,burn,showing_scarcely_suppressed_anger,spirit]

smoulder=[#sad,#scared,fire,smolder,firing,flame,flaming]

smudge=[#sad,#disgusting,a_blemish_made_by_dirt,fire,blemish,spot,blot]

smugly=[#sad,#scared,smug,self_satisfy,self-satisfied,complacent,self-complacent]

snag=[#sad,#scared,hitch,hew,a_sharp_protuberance,obtain,tree]

snappish=[#sad,#scared,apt_to_speak_irritably,temper,snappy,pique,irritation]

snare=[#sad,#scared,string,trap,a_trap_for_birds_or_small_mammals,surgical_instrument,snare_drum]

somber=[#sad,#scared,graveness,grave_or_even_gloomy_in_character,gloom,gravity,sobriety]

sour=[#sad,#angry,acid,taste,change_state,acerb,acetose]

spade=[#sad,#scared,dig,a_sturdy_hand_shovel_that_can_be_pushed_into_the_earth_with_the_foot,dig_with_a_spade,play_card,major_suit]

spew=[#sad,#disgusting,eruption,exhaust,drink_alert,volcanic_eruption,eructation]

spinster=[#sad,#scared,unmarried_woman,house_of_correction,old_maid,spin_doctor,old_maid]

spotty=[#sad,#scared,unevenness,variability,patched,spotted,uneven]

sputter=[#sad,#angry,pop,spatter,utter,utterance,the_noise_of_something_spattering_or_sputtering_explosively]

squander=[#sad,#angry,not_used_to_good_advantage,waste,spending_resources_lavishly_and_wastefully,blow,consume]

squeal=[#sad,#disgusting,utter,howl,hog,oink,confess]

stagnant=[#sad,#scared,stagnate,stagnation,dead,moribund,idle]

stagnate=[#sad,#disgusting,stagnation,a_state_of_inactivity,be,stand_still,inactivity_of_liquids]

stale=[#sad,#scared,make,hard,putrid,staleness,addle]

stalemate=[#sad,#angry,draw,move,chess,drawing_card,attraction]

stall=[#sad,#scared,in_bathroom,airplane_accident,unite_kingdom,seat,delay]

stampede=[#sad,#scared,group_action,change_of_location,rush,act,flee]

stark=[#sad,#scared,starkness,new_york,absoluteness,utterness,bareness]

starkly=[#sad,#scared,blunt,arrant,austere,numb,benumb]

steal=[#sad,#disgusting,you_have_no_money,skid,baseball,gain,slip]

stereotype=[#sad,#scared,a_conventional_or_formulaic_conception_or_image,representation,lacking_spontaneity_or_originality_or_individuality,normal_thing,pigeonhole]

stern=[#sad,#scared,soviet_union,the_rear_part_of_a_ship,ship,violinist,sternness]

stigmatize=[#sad,#scared,mark,denunciation,stigmatization,make_or_leave_a_mark_on,label]

stodgy=[#sad,#scared,heavy_and_starchy_and_hard_to_digest,stodginess,excessively_conventional_and_unimaginative_and_hence_dull,old_fashion,fogyish]

straggle=[#sad,#scared,a_wandering_or_disorderly_grouping,group,sidetrack,depart,digress]

stricken=[#sad,#scared,musical_composition,music_single,rub_out,musical_work,hard_rock]

strictly=[#sad,#scared,rigorous,demanding_strict_attention_to_rules_and_procedures,strictly_proper,strict,stringent]

strife=[#sad,#scared,conflict,bitter_conflict,discord,struggle,battle]

stubbornly=[#sad,#scared,hardheaded,bullheaded,stubborn,cuss,mulish]

stuffy=[#sad,#scared,stuffiness,stuff_shirt,stuff_animal,plush_toy,closeness]

stump=[#sad,#angry,limb,perplex,cricket,clear,plant_part]

stupidly=[#sad,#scared,stupid,cloddish,stupid_person,stupe,dullard]

sty=[#sad,#scared,pen,infection,playpen,penitentiary,write]

subjugate=[#sad,#disgusting,conquest,subjugation,dominate,make_subservient,reduced_to_submission]

subjugation=[#sad,#scared,forced_submission_to_control_by_others,relationship,subjection,oppression,conquest]

subordinate=[#sad,#disgusting,mastery,grammar,subject,insubordinate,subordinateness]

subpoena=[#sad,#scared,writ,law,serve,compel_testimony,take_stand]

subservience=[#sad,#scared,the_condition_of_being_something_that_is_useful_in_reaching_an_end_or_carrying_out_a_plan,in_a_subservient_state,subordinateness,condition,subservientness]

subservient=[#sad,#scared,subservience,subservientness,obsequiousness,servility,implemental]

subversion=[#sad,#scared,the_act_of_subverting,overthrow,software_object,computer_game,corruption]

sucker=[#sad,#scared,mostly_north_american_freshwater_fishes_with_a_thick_lipped_mouth_for_feeding_by_suction,organ,shoot,a_drinker_who_sucks,an_organ_specialized_for_sucking_nourishment_or_for_adhering_to_objects_by_suction]

sue=[#sad,#scared,writer,have_lawyer,dance_very_well,leave_school_early,middle_name]

sully=[#sad,#scared,painter,statesman,cougar,puma,catamount]

suppression=[#sad,#scared,growth,forceful_prevention,restraint,prevention,the_act_of_withholding_or_withdrawing_some_book_or_writing_from_publication_or_circulation]

swagger=[#sad,#disgusting,act,pedestrian,someone_who_walks_in_an_arrogant_manner,loudmouth,flamboyantly_adventurous]

swipe=[#sad,#disgusting,stroke,sideswipe,hit,pilfer,cabbage]

syndrome=[#sad,#scared,a_pattern_of_symptoms_indicative_of_some_disease,complex,disease,symptom,composite]

tamper=[#sad,#disgusting,imp,manipulate,elf,hob,gremlin]

tangle=[#sad,#scared,perplexity,a_twisted_and_tangled_mass_that_is_highly_interwoven,something_jumbled_or_confused,enmesh,mat]

taut=[#sad,#scared,tightness,tension,subjected_to_great_tension,pulled_or_drawn_tight,stringency]

tenuous=[#sad,#scared,rarity,thinness,having_thin_consistency,rareness,infrequency]

terribly=[#sad,#scared,atrocious,colloquialism,icky,flagitious,grievous]

thoughtlessly=[#sad,#scared,thoughtless,without_care_or_thought_for_others,in_a_thoughtless_manner,unreflective,unthinkingly]

torrent=[#sad,#scared,current,a_violently_fast_stream_of_water,fast_move_stream,tv_show,peer_to_peer]

tortuous=[#sad,#scared,complicatedness,not_straightforward,tortuosity,complication,knottiness]

tout=[#sad,#disgusting,advertiser,pronounce,scalper,unite_kingdom,tout_court]

tragic=[#sad,#scared,drama,tragedy,calamity,drama_in_which_the_protagonist_is_overcome_by_some_superior_force_or_circumstance,very_sad]

trample=[#sad,#angry,the_sound_of_heavy_treading_or_stomping,trampler,sound,injure,destroy_sensitive_vegetation]

transgression=[#sad,#scared,the_act_of_transgressing,the_spreading_of_the_sea_over_land_as_evidenced_by_the_deposition_of_marine_strata_over_terrestrial_strata,wrongdoing,geological_phenomenon,action]

trap=[#sad,#angry,snarer,trapper,immobilization,hunt,catch_in_or_as_if_in_a_trap]

traumatic=[#sad,#scared,injury,trauma,any_physical_damage_to_the_body_caused_by_violence_or_accident_or_fracture_etc,hurt,harm]

traumatize=[#sad,#angry,daze,shock,injure,injury,trauma]

travesty=[#sad,#disgusting,farce,spoof,write_work,farce_comedy,forcemeat]

treason=[#sad,#scared,crime,disloyalty_by_virtue_of_subversive_behavior,a_crime_that_undermines_the_offender's_government,disloyalty,high_treason]

trivialize=[#sad,#disgusting,make_trivial_or_insignificant,understate,trivialise,minimize,minimise]

ultimatum=[#sad,#scared,demand,type_of_thing,tv_show,television_show,indie_rock]

unacceptably=[#sad,#scared,acceptable,tolerable,satisfactory,intolerably,adequate]

unachievable=[#sad,#scared,unattainableness,impossible_to_achieve,unattainable,undoable,unrealizable]

unappealing=[#sad,#scared,off_put,unattractive,not_able_to_attract_favorable_attention,unsympathetic,unlikeable]

unbelievably=[#sad,#scared,incredible,incredibly,improbably,implausibly,unbelievable]

uncivil=[#sad,#scared,lacking_civility_or_good_manners,discourtesy,rude,disrespect,rudeness]

uncompromising=[#sad,#scared,compromise,inflexibility,sturdiness,hard_line,sturdy]

unconvincing=[#sad,#scared,flimsiness,unpersuasive,not_convincing,flimsy,improbable]

unconvincingly=[#sad,#scared,unconvincing,flimsy,improbable,unbelievable,unlikely]

uncreative=[#sad,#scared,sterile,uncreativeness,not_creative,unfertile,infertile]

undecided=[#sad,#scared,of_two_mind,open,undetermined,unresolved,on_the_fence]

undefined=[#sad,#scared,indefinable,vagueness,vague,undefinable,indescribable]

undercut=[#sad,#scared,the_material_removed_by_a_cut_made_underneath,a_cut_made_underneath_to_remove_material,a_notch_cut_in_the_trunk_of_tree_in_order_to_determine_the_direction_of_its_fall,cut,the_act_of_cutting_something_into_parts]

undue=[#sad,#scared,lacking_justification_or_authorization,not_appropriate_or_proper_in_the_circumstances,law,not_yet_payable,unjustified]

uneconomical=[#sad,#scared,waste,wasteful_of_resources,waste_material,waste_matter,waste_product]

unforgiving=[#sad,#scared,unwilling_or_unable_to_forgive_or_show_mercy,revengeful,symphonic_metal,musical_work,grim]

unfortunately=[#sad,#scared,unfortunate,doom,regrettable,sad_to_say,unfortunate_person]

ungrateful=[#sad,#scared,not_feeling_or_showing_gratitude,ingratitude,unappreciative,thankless,unthankful]

unhappily=[#sad,#scared,unhappy,sadly,dysphoric,distressed,infelicitous]

unhelpful=[#sad,#scared,providing_no_assistance,unhelpfulness,unaccommodating,unconstructive,unobliging]

unimaginably=[#sad,#scared,impossible,unthinkable,inconceivable,out_of_the_question,unimaginable]

unintelligible=[#sad,#scared,slur,unintelligibility,poorly_articulated_or_enunciated_or_drowned_by_noise,opaque,aspersion]

unjustifiably=[#sad,#scared,excusable,indefensible,forgivable,venial,untenable]

unkindly=[#sad,#scared,unkind,lacking_in_sympathy_and_kindness,unsympathetic,pitiless,unappealing]

unlawful=[#sad,#scared,unlawfulness,lawless,wide_open,contrary_to_or_prohibited_by_or_defiant_of_law,wrongful]

unlawfully=[#sad,#scared,illegitimate,bastard,by-blow,love_child,illegitimate_child]

unleash=[#sad,#angry,let_go_of,release_as_from_one's_grip,single_broadcast_tv_show,let_loose,loose]

unlikely=[#sad,#scared,last,outside,unlikelihood,farfetched,has_little_chance_of_being_the_case_or_coming_about]

unlucky=[#sad,#scared,hex,jinx,curse,whammy,bewitch]

unnaturally=[#sad,#scared,unnatural,naturally,affect,artificially,by_artificial_means]

unorthodox=[#sad,#scared,nonconforming,dissident,dissentient,reform,breaking_with_convention_or_tradition]

unorthodoxy=[#sad,#scared,orientation,originality,the_quality_of_being_unorthodox,orthodoxy,any_opinions_or_doctrines_at_variance_with_the_official_or_orthodox_position]

unravel=[#sad,#disgusting,disentangler,ravel,separate,undo,musical_composition]

unreasonably=[#sad,#scared,immoderate,unreasonable,excessive,not_in_a_reasonable_or_intelligent_manner,inordinate]

unsavory=[#sad,#scared,transgress,disgustingness,odoriferous,shock,offensiveness]

unsound=[#sad,#scared,unsoundness,decay,bad,wildcat,corrode]

unsteadily=[#sad,#scared,falter,steadily,uncertain,unsteady,hesitation]

unsteadiness=[#sad,#scared,the_quality_of_being_unsteady_varying_and_unpredictable,the_quality_of_not_being_steady_or_securely_fixed_in_place,irregularity,movability,steadiness]

unsupportive=[#sad,#scared,confound,disconfirming,confuse,throw,fox]

unthinkable=[#sad,#scared,incapable_of_being_conceived_or_considered,impossible,common_sense,inconceivable,out_of_the_question]

untrue=[#sad,#scared,not_according_with_the_facts,not_true_to_an_obligation_or_trust,out_of_true,false,mistaken]

untrustworthy=[#sad,#scared,untrustworthiness,slippery,devious,fly_by_night,untrustiness]

unusually=[#sad,#scared,remarkable,unusual,remarkably,outstandingly,unco]

unwise=[#sad,#scared,folly,foolishness,unwiseness,stupidity,betise]

unworthy=[#sad,#scared,unmerited,unmeritorious,undeserving,unworthiness,lacking_in_value_or_merit]

uproot=[#sad,#angry,displace,displacement,move,to_move_something_from_its_natural_environment,extirpation]

vagueness=[#sad,#scared,unclearness_by_virtue_of_being_poorly_expressed_or_not_coherent_in_meaning,indistinctness,unclearness,softness,blurriness]

vainly=[#sad,#scared,bootless,in_vain,fruitless,futile,sleeveless]

vehement=[#sad,#scared,ferocity,fierceness,furiousness,fury,vehemence]

vilify=[#sad,#disgusting,vituperation,abuse,smear,defamer,use_foul_or_abusive_language_towards]

violently=[#sad,#scared,nonviolently,violent,wild,fierce,tearing]

virulence=[#sad,#scared,harmfulness,hostility,extreme_hostility,extreme_harmfulness,microorganism]

virulent=[#sad,#scared,deadly,virulence,avirulent,highly_infective,deathly]

volatile=[#sad,#scared,volatilize,volatility,nonvolatile,a_volatile_substance,chemistry]

wane=[#sad,#scared,ebb,decrease_in_phase,a_gradual_decrease_in_magnitude_or_extent,become_smaller,decrease]

wanton=[#sad,#scared,lewd_or_lascivious_woman,chat_up,live,spend,act]

warily=[#sad,#scared,unwarily,wary,leery,mistrustful,suspicious]

wariness=[#sad,#scared,unwary,unwariness,circumspection,wary,the_trait_of_being_cautious_and_watchful]

warlike=[#sad,#scared,suggesting_war_or_military_life,militant,hawkish,martial,activist]

wasteful=[#sad,#scared,waste,extravagant,pound_foolish,tending_to_squander_and_waste,thriftlessness]

wheedle=[#sad,#scared,coaxial_cable,blandishment,wheedler,persuade,blarney]

whimper=[#sad,#angry,a_complaint_uttered_in_a_plaintive_whining_way,complaint,whine,wail,mewl]

wickedly=[#sad,#scared,evil,wicked,immorality,wickedness,iniquity]

wildly=[#sad,#scared,wild,in_a_state_of_extreme_emotion,marked_by_extreme_lack_of_restraint_or_control,natural_state,state_of_nature]

wince=[#sad,#disgusting,startle,the_facial_expression_of_sudden_pain,grimace,facial_expression,flinch]

wobble=[#sad,#scared,move,an_unsteady_rocking_motion,wobbler,movement,fluctuating_unsteadily]

womanizer=[#sad,#scared,a_man_who_likes_many_women_and_has_short_sexual_relationships_with_them,libertine,man,lady's_man,womaniser]

wrest=[#sad,#angry,seize,wrester,string_instrument,water_wheel,prehend]

wrestle=[#sad,#angry,join_wrestle_team,get_hurt,be_strong,close_in_fight,wrestler]

wretchedness=[#sad,#scared,discomfort,inferiority,the_quality_of_being_poor_and_inferior_and_sorry,misery,miserableness]

writhe=[#sad,#scared,twist,tornado,move,wiggler,wiggle]

wrongful=[#sad,#scared,wrong,that_which_is_contrary_to_the_principles_of_justice_or_law,unlawfully_violating_the_rights_of_others,not_just_or_fair,wrongfulness]

zap=[#sad,#disgusting,zapper,event,affect,kill,microwave_oven]

zealot=[#sad,#scared,jew,fictitious_character,believe_blindly,cartoon_character,Jew]

zealously=[#sad,#scared,avid,with_will,devouring,esurient,greedy]

