abound=[#joyful,#surprising,burst,existing_in_abundance,be,abound_in,abundance]

accommodative=[#surprising,#interesting,suit,amenability,tending_to_reconcile_or_accommodate,suit_of_clothes,lawsuit]

accurately=[#surprising,#joyful,accurate,inaccurately,conforming_exactly_or_almost_exactly_to_fact_or_to_a_standard_or_performing_with_total_accuracy,exact,precise]

acumen=[#surprising,#interesting,plant_process,a_tapering_point,learn_smart,sharp_mind,sharp_ability]

adaptable=[#surprising,#interesting,adapt,convertible,adjust,elastic,adaptability]

adaptive=[#surprising,#interesting,maladaptive,adapt,adjust,accommodative,adaptational]

affable=[#surprising,#joyful,amity,good_humor,a_state_of_friendship_and_cordiality,diffusing_warmth_and_friendliness,affability]

affectation=[#surprising,#joyful,a_deliberate_pretense_or_exaggerated_display,pretense,mannerism,pose,affectedness]

affluence=[#surprising,#joyful,abundant_wealth,wealth,richness,wealthiness,riches]

affluent=[#surprising,#joyful,wealth,affluence,rich_person,having_an_abundant_supply_of_money_or_possessions_of_value,flower]

agreeableness=[#surprising,#interesting,disagreeableness,a_temperamental_disposition_to_be_agreeable,the_quality_of_being_disagreeable_and_unpleasant,pleasantness_resulting_from_agreeable_conditions,pleasantness]

ambitiously=[#surprising,#interesting,unambitiously,compulsive,ambitious,determined,driven]

ameliorate=[#joyful,#surprising,good,get_better,goodness,commodity,trade_good]

amity=[#surprising,#joyful,a_state_of_friendship_and_cordiality,friendliness,peace,a_cordial_disposition,musical_work]

ample=[#surprising,#joyful,ampleness,batch,the_property_of_being_more_than_sufficient,full,generous]

amply=[#surprising,#interesting,ample,meagerly,more_than_enough_in_size_or_scope_or_capacity,richly,fully]

appreciative=[#surprising,#admirable,prize,gratefulness,appreciate,having_or_showing_appreciation_or_a_favorable_critical_judgment_or_opinion,feeling_or_expressive_of_gratitude]

ardent=[#surprising,#joyful,characterized_by_intense_emotion,fieriness,ardor,characterized_by_strong_enthusiasm,fervent]

articulate=[#joyful,#surprising,unarticulated,articulation,joint,speech_endow,inarticulate]

aspiration=[#surprising,#joyful,articulation,ambition,a_will_to_succeed,join,joint]

astutely=[#surprising,#interesting,perspicacious,astute,sagacious,sapient,clear-eyed]

authentic=[#surprising,#admirable,authenticity,indisputability,conforming_to_fact_and_therefore_worthy_of_belief,dependability,not_counterfeit_or_copied]

autonomous=[#surprising,#admirable,autonomy,existing_as_an_independent_entity,independence,free_from_external_control_and_constraint_in_e_g_action_and_judgment,personal_independence]

beauteous=[#surprising,#admirable,comeliness,beauty,fairness,loveliness,beauteousness]

benefactor=[#surprising,#admirable,a_person_who_helps_people_or_institutions,good_person,person_type,computer_game,helper]

blameless=[#surprising,#interesting,blamelessness,free_of_guilt,inculpable,irreproachable,unimpeachable]

blissful=[#surprising,#interesting,bliss,completely_happy_and_contented,on_cloud_nine,blissfulness,cloud_nine]

blithe=[#surprising,#joyful,carefreeness,lacking_or_showing_a_lack_of_due_concern,carefree_and_happy_and_lighthearted,cartoon_character,blithesome]

blockbuster=[#surprising,#admirable,fictitious_character,hit,cartoon_character,general_purpose_bomb,trope]

bonny=[#surprising,#interesting,very_pleasing_to_the_eye,comeliness,music_single,musical_work,instrumental_rock]

boundless=[#surprising,#admirable,infiniteness,seemingly_boundless_in_amount_number_degree_or_especially_extent,infinitude,unboundedness,boundlessness]

brainy=[#surprising,#interesting,brilliance,brain,genius,luster,having_or_marked_by_unusual_and_impressive_intelligence]

bravo=[#joyful,#surprising,cheer,applaud,assassin,assassinator,cheerfulness]

brighten=[#joyful,#surprising,change,alteration,modification,variety,alter]

brilliance=[#surprising,#admirable,intelligence,unusual_mental_ability,intelligence_service,intelligence_agency,intelligence_information]

brilliantly=[#surprising,#interesting,brilliant,bright,brainy,superb,smart_as_a_whip]

catchy=[#surprising,#joyful,catch,trickiness,gimmick,haul,match]

celebratory=[#surprising,#joyful,celebration,celebrate,jubilation,festivity,solemnization]

champ=[#joyful,#surprising,chew,new_york,loch_ness_monster,mash_potato,musical_work]

charismatic=[#surprising,#interesting,attraction,charisma,possessing_an_extraordinary_ability_to_attract,holy_spirit,charismatic_movement]

chivalrous=[#surprising,#interesting,squire,knight,chivalry,being_attentive_to_women_like_an_ideal_knight,gallant]

civilize=[#joyful,#surprising,civilization,a_society_in_an_advanced_state_of_social_development,humane,marked_by_refinement_in_taste_and_manners,breed]

cleanly=[#surprising,#admirable,cleanliness,clean,flawlessly,clean_and_jerk,make_clean]

clearly=[#surprising,#admirable,clear,readily_apparent_to_the_mind,open,unclutter,clear_up]

cohere=[#joyful,#surprising,be,change,have_internal_elements_or_parts_logically_connected_so_that_aesthetic_consistency_results,cause_to_form_a_united_orderly_and_aesthetically_consistent_whole,common_purpose]

coherent=[#surprising,#admirable,incoherent,coherence,consistency,cling,the_state_of_cohering_or_sticking_together]

cohesive=[#surprising,#admirable,cohere,coherence,causing_cohesion,the_state_of_cohering_or_sticking_together,cling]

commodious=[#surprising,#admirable,archaism,capaciousness,incommodious,roomy,archaicism]

compact=[#joyful,#surprising,clayey,pack,case,compaction,be]

compactly=[#surprising,#joyful,compact,closely_and_firmly_united_or_packed_together,powder_compact,covenant,concordat]

compliant=[#surprising,#joyful,complaisance,nonresistant,comply,amenable,lamblike]

comprehensive=[#surprising,#interesting,countrywide,omnibus,breadth,large,encyclopedic]

conciliatory=[#surprising,#admirable,pacify,reconcile,pacific,propitiative,soft]

concise=[#surprising,#interesting,aphoristic,conciseness,telegraphic,crisp,expressing_much_in_few_words]

congenial=[#surprising,#admirable,sociable,uncongenial,congenialness,capable_of_cross_fertilization_or_of_being_grafted,social]

congratulatory=[#surprising,#joyful,congratulate,compliment,preen,pride,felicitate]

conscientious=[#surprising,#admirable,unconscientious,conscience,conscientiousness,meticulousness,conformity_to_one's_own_sense_of_right_conduct]

considerate=[#surprising,#joyful,inconsiderate,thoughtful,consideration,unconsidered,serious-minded]

contrasty=[#surprising,#joyful,contrast,photography,direct_contrast,line,dividing_line]

convincingly=[#surprising,#joyful,unconvincingly,convince,convert,win_over,change_over]

cooperative=[#surprising,#interesting,commercial_enterprise,collaborative,amenability,association,collaborate]

cornerstone=[#surprising,#joyful,stone,building_material_consisting_of_a_piece_of_rock_hewn_in_a_definite_shape_for_a_special_purpose,build,a_structure_that_has_a_roof_and_walls_and_stands_more_or_less_permanently_in_one_place,part_of_build]

correctly=[#surprising,#joyful,veracious,incorrectly,right,falsely,wrongly]

credence=[#surprising,#joyful,attitude,the_mental_attitude_that_something_is_believable_and_should_be_accepted_as_true,acceptance,credenza,mental_attitude]

credible=[#surprising,#admirable,credibility,incredible,appearing_to_merit_belief_or_acceptance,capable_of_being_believed,believe]

cushy=[#surprising,#admirable,not_burdensome_or_demanding,colloquialism,soft,easygoing,delicate]

daringly=[#surprising,#joyful,avant_garde,audacious,brave,dauntless,fearless]

dazzle=[#surprising,#joyful,brightness,blind,stupefied_or_dizzied_by_something_overpowering,amazingly_impressive,daze]

deft=[#surprising,#admirable,adeptness,dexterity,skillful_in_physical_movements,adroitness,deftness]

delectable=[#surprising,#interesting,delectability,extremely_pleasing_to_the_sense_of_taste,musical_work,rock_and_roll,deliciousness]

delightful=[#surprising,#interesting,greatly_pleasing_or_entertaining,delicious,Delicious,delectable,luscious]

dignify=[#joyful,#surprising,having_or_showing_self_esteem,courtly,lift,undignified,distinguish]

diplomatic=[#surprising,#interesting,undiplomatic,diplomat,diplomacy,tactful,using_or_marked_by_tact_in_dealing_with_sensitive_matters_or_people]

distinctive=[#surprising,#admirable,peculiarity,distinctive_feature,distinguishing_characteristic,specialness,specialty]

dreamland=[#surprising,#joyful,fantasy_land,single_broadcast_tv_show,musical_work,write_work,television_episode]

ebullient=[#surprising,#admirable,exuberate,exuberance,overflowing_with_eager_enjoyment_or_approval,high_spiritedness,joyously_unrestrained]

edify=[#joyful,#surprising,unedifying,enlighten,unenlightening,irradiate,clear]

effectively=[#surprising,#admirable,effective,for_all_practical_purpose,effectual,efficacious,efficient]

efficacious=[#surprising,#admirable,inefficacious,effective,marked_by_qualities_giving_the_power_to_produce_an_intended_effect,efficacy,effectual]

efficiently=[#surprising,#admirable,effective,expeditious,inefficiently,effectual,efficacious]

effortless=[#surprising,#interesting,effortlessness,unforced,facile,uncoerced,willing]

effusive=[#surprising,#joyful,effusion,extravagantly_demonstrative,burbling,burbly,gushing]

elegantly=[#surprising,#joyful,elegant,displaying_effortless_beauty_and_simplicity_in_movement_or_execution,inelegantly,graceful,refined]

eloquence=[#surprising,#interesting,expressive_style,tangible_agent,fluency,smoothness,volubility]

eloquent=[#surprising,#joyful,expressing_yourself_readily_clearly_effectively,elocute,facility,fluency,eloquence]

eloquently=[#surprising,#joyful,articulate,eloquent,ineloquently,joint,give_voice]

eminent=[#surprising,#admirable,standing_above_others_in_quality_or_position,highness,stateliness,eminence,a_high_degree]

endear=[#joyful,#surprising,endearment,please,delight,delectation,joy]

endorsement=[#surprising,#interesting,signature,a_signature_that_validates_something,a_promotional_statement,the_act_of_endorsing,support]

enhancement=[#surprising,#admirable,improvement,an_improvement_that_makes_something_more_agreeable,betterment,advance,melioration]

enough=[#surprising,#joyful,an_adequate_quantity,relative_quantity,sufficiency,adequate,decent]

enrichment=[#surprising,#joyful,a_gift_that_significantly_increases_the_recipient's_wealth,act_of_making_fuller_or_more_meaningful_or_rewarding,improvement,gift,enrich_uranium]

enterprising=[#surprising,#interesting,unenterprising,energetic,enterprise,entrepreneurial,nonenterprising]

enthuse=[#interesting,#surprising,excite,cause_to_feel_enthusiasm,talk,stimulate,stir]

equitable=[#surprising,#joyful,honest,evenhanded,inequitable,justice,just]

ethical=[#surprising,#joyful,ethical_motive,honorableness,unethical,motivation_based_on_ideas_of_right_and_wrong,ethic]

eulogize=[#joyful,#surprising,eulogy,praise,eulogium,encomium,panegyric]

evenly=[#surprising,#admirable,unevenly,even,in_an_unequal_or_partial_manner,equal,equal_in_degree_or_extent_or_amount]

eventful=[#surprising,#joyful,uneventful,lively,music_single,musical_composition,web_service]

exaltation=[#surprising,#interesting,flock,celestial_point,zodiac,collective_noun,batch]

excellently=[#surprising,#interesting,brilliant,excellent,superb,brainy,smart_as_a_whip]

excitingly=[#surprising,#interesting,unexcitingly,excite,stimulate,stir,agitate]

exemplary=[#surprising,#admirable,exemplar,example,model,good_example,emblematic]

expertly=[#surprising,#joyful,amateurishly,adept,ace,champion,sensation]

exquisite=[#surprising,#joyful,exquisiteness,intense_or_sharp,of_extreme_beauty,keen,recherche]

facilitate=[#joyful,#surprising,facilitator,physiology,help,facilitation,the_condition_of_being_made_easy]

fairly=[#surprising,#interesting,unfairly,fair,free_from_favoritism_or_self_interest_or_bias_or_deception,below_the_belt,carnival]

faithfully=[#surprising,#joyful,unfaithfully,reliable,faithful,single_broadcast_tv_show,yours_faithfully]

fanfare=[#surprising,#joyful,announce_begin_of_festivity,post_punk,new_wave_music,punk_rock,classical_music]

faultless=[#surprising,#joyful,faultlessness,without_fault_or_error,impeccability,immaculate,impeccable]

feasible=[#surprising,#admirable,bring,feasibility,practicability,capable_of_being_done_with_means_at_hand_and_circumstances_as_they_are,executability]

feisty=[#surprising,#joyful,showing_courage,gutsiness,heart,plucky,spunky]

felicity=[#surprising,#admirable,infelicitous,appropriateness,pleasing_and_appropriate_manner_or_style,infelicity,felicitous]

fidelity=[#surprising,#joyful,unfaithful,infidelity,faithful,the_quality_of_being_faithful,quality]

finely=[#surprising,#interesting,dainty,delicate,fine,of_textures_that_are_smooth_to_the_touch_or_substances_consisting_of_relatively_small_particles,delicacy]

flashy=[#surprising,#admirable,flashiness,ostentation,flamboyance,garishness,marked_by_conspicuous_display]

flawless=[#surprising,#interesting,perfection,without_a_flaw,flawlessness,ne_plus_ultra,paragon]

flawlessly=[#surprising,#joyful,clean,flawless,race_horse,clean_and_jerk,make_clean]

fluent=[#surprising,#interesting,smoothness,eloquence,fluency,suavity,suaveness]

flutter=[#joyful,#surprising,beat,cardiac_arrhythmia,waver,flicker,disturbance]

foremost=[#surprising,#admirable,preceding_all_others_in_spatial_position,first,world-class,frontmost,firstly]

foresight=[#surprising,#interesting,providence,something_everyone_know_about,foresightedness,foresightfulness,prevision]

fortitude=[#surprising,#joyful,courage,natural_virtue,cardinal_virtue,inner_strength,courageousness]

fortuitous=[#surprising,#joyful,fortuitousness,occurring_by_happy_chance,causeless,uncaused,reasonless]

fortunately=[#surprising,#joyful,lucky,unfortunately,fortunate,fortuitous,golden]

gallant=[#surprising,#interesting,having_or_displaying_great_dignity_or_nobility,stateliness,dandy,dude,fop]

gallantly=[#surprising,#joyful,unchivalrously,chivalrous,gallant,knightly,dandy]

galore=[#surprising,#interesting,musical_composition,great_hit_album,alternative_rock,musical_work,indie_pop]

genial=[#surprising,#interesting,chin,mentum,Kuki,Chin,Kuki-Chin]

glisten=[#joyful,#surprising,polish,shininess,gloss,glossiness,burnish]

glitter=[#joyful,#surprising,flicker,the_quality_of_shining_with_a_bright_reflected_light,flash,be_shiny_as_if_wet,the_occurrence_of_a_small_flash_or_spark]

goodly=[#surprising,#admirable,enormousness,heft,grandness,greatness,immenseness]

gorgeously=[#surprising,#admirable,brilliant,gorgeous,glorious,superb,brainy]

gracefully=[#surprising,#interesting,gracelessly,graceful,ungraciously,ungracefully,woodenly]

graciously=[#surprising,#admirable,ungraciously,elegant,gracious,ungracefully,gracelessly]

groundbreaking=[#surprising,#interesting,begin,ceremony,cut_edge,break_grind,Begin]

gutsy=[#surprising,#interesting,backbone,gutless,gutsiness,anchor,mainstay]

hallmark=[#surprising,#admirable,characteristic,a_distinctive_characteristic_or_attribute,manufacturer_of_birthday_card,trademark,earmark]

handily=[#surprising,#joyful,handy,convenient,inconveniently,Handy,W._C._Handy]

handsomely=[#surprising,#admirable,fine_look,big,large,bad,prominent]

harmless=[#surprising,#admirable,innocent,harmful,inexperienced_person,guiltless,clean-handed]

headway=[#surprising,#admirable,forward_movement,progress,ahead_way,alternative_rock,pop_rock]

heartily=[#surprising,#admirable,hearty,warm,without_reservation,cordial,with_will]

heroic=[#surprising,#interesting,act,hero,plural,a_being_of_great_strength_and_courage_celebrated_for_bold_exploits,champion]

honorable=[#surprising,#joyful,honorableness,time_honor,dishonorable,august,worthy_of_being_honored]

humane=[#surprising,#interesting,showing_evidence_of_moral_and_intellectual_advancement,marked_or_motivated_by_concern_with_the_alleviation_of_suffering,inhumane,humaneness,child_center]

humorous=[#surprising,#joyful,kill,wit,buffoonish,farcical,waggish]

idealize=[#joyful,#surprising,idealization,ideal,consider_or_render_as_ideal,see,the_idea_of_something_that_is_perfect]

idyllic=[#surprising,#joyful,idyll,excellent_and_delightful_in_all_respects,suggestive_of_an_idyll,an_episode_of_such_pastoral_or_romantic_charm_as_to_qualify_as_the_subject_of_a_poetic_idyll,pastorale]

illuminate=[#joyful,#surprising,art,miniature,paint,decorate,provided_with_artificial_light]

illustrious=[#surprising,#interesting,greatness,having_or_conferring_glory,celebrated,famed,far-famed]

immaculate=[#surprising,#admirable,spotlessness,free_from_stain_or_blemish,completely_neat_and_clean,immaculateness,speckless]

impartiality=[#surprising,#interesting,an_inclination_to_weigh_both_views_or_opinions_equally,inclination,nonpartisanship,disposition,tendency]

impressively=[#surprising,#admirable,impressive,unimpressively,baronial,telling,imposing]

incredible=[#surprising,#joyful,undreamed,beyond_belief_or_understanding,incredibility,improbable,fabulous]

incredibly=[#surprising,#interesting,improbable,credibly,implausible,incredible,unlikely]

indebted=[#surprising,#interesting,obligation,owing_gratitude_or_recognition_to_another_for_help_or_favors_etc,indebtedness,duty,responsibility]

innocuous=[#surprising,#joyful,innoxious,not_causing_disapproval,unobjectionable,innocent,clean]

innovative=[#surprising,#interesting,invention,initiation,introduce,the_creation_of_something_in_the_mind,innovativeness]

instructive=[#surprising,#admirable,didactic,explanatory,expository,inform,teach]

invaluable=[#surprising,#admirable,invaluableness,preciousness,pricelessness,valuableness,priceless]

invincible=[#surprising,#admirable,indomitability,incapable_of_being_overcome_or_subdued,cartoon_character,fictitious_character,musical_composition]

irreplaceable=[#surprising,#admirable,irreplaceableness,music_single,musical_work,pop_music,unreplaceable]

irresistible=[#surprising,#interesting,overpower,irresistibility,impossible_to_resist,the_quality_of_being_overpowering_and_impossible_to_resist,overmaster]

keen=[#joyful,#surprising,ireland,dirge,having_a_sharp_cutting_edge_or_point,lament,acute]

lavish=[#joyful,#surprising,extravagance,characterized_by_extravagance_and_profusion,very_generous,consume,munificence]

lavishly=[#surprising,#interesting,lavish,rich,shower,munificent,overgenerous]

lawful=[#surprising,#interesting,authorized_sanctioned_by_or_in_accordance_with_law,according_to_custom_or_rule_or_natural_law,licitness,lawfulness,conformable_to_or_allowed_by_law]

leverage=[#joyful,#surprising,strategic_advantage,advantage,mechanical_phenomenon,investing_with_borrowed_money_as_a_way_to_amplify_potential_gains,invest]

likable=[#surprising,#interesting,like,the_like,the_likes_of,ilk,wish]

lucidly=[#surprising,#interesting,coherent,limpid,consistent,logical,ordered]

maneuverable=[#surprising,#interesting,steer,maneuverability,tip,lead,confidential_information]

masterpiece=[#surprising,#joyful,work,accomplishment,conceptual_work,chef_d'œuvre,piece_of_work]

mastery=[#surprising,#interesting,the_act_of_mastering_or_subordinating_someone,domination,philosopher's_stone,command,control]

maturely=[#surprising,#joyful,mature,maturate,grow,ripen,senesce]

meritorious=[#surprising,#admirable,deserve,deservingness,deserving_reward_or_praise,meritable,merit]

mighty=[#surprising,#admirable,intensifier,might,intensive,mightily,powerful]

modest=[#surprising,#admirable,shamefaced,immodest,modesty,coy,decent]

momentous=[#surprising,#interesting,consequence,momentousness,of_very_great_significance,effect,outcome]

noteworthy=[#surprising,#interesting,worthy_of_notice,notable,remarkable,luminary,leading_light]

oasis=[#surprising,#admirable,tract,desert,natural_thing,musical_composition,computer_game]

outshine=[#joyful,#surprising,surpass,shine,alternative_metal,musical_work,heavy_metal_music]

outstandingly=[#surprising,#interesting,outstanding,race_horse,prominent,salient,spectacular]

outwit=[#joyful,#surprising,beat_through_cleverness_and_wit,surpass,get_good_of,overreach,outsmart]

ovation=[#surprising,#admirable,recognition,acknowledgment,acknowledgement,identification,credit]

overtake=[#interesting,#surprising,pass,catch,compete,take_over,base_on_balls]

overture=[#surprising,#joyful,suggestion,music,preliminary,prelude,advance]

palatial=[#surprising,#interesting,palace,official_residence_of_an_exalted_person,a_large_and_stately_mansion,castle,rook]

pep=[#surprising,#joyful,liveliness,post_exposure_prophylaxis,high_spirit,parow_cape_town,cape_town]

perfectly=[#surprising,#admirable,perfect,imperfectly,perfective,perfective_tense,perfect_tense]

permissible=[#surprising,#interesting,permit,that_may_be_permitted_especially_as_according_to_rule,impermissible,permissibility,allowable]

perseverance=[#surprising,#admirable,the_act_of_persisting_or_persevering,continuance,doggedness,persistence,persistency]

pleasantly=[#surprising,#joyful,enjoyable,cheery,unpleasantly,pleasant,disagreeably]

plush=[#surprising,#interesting,fabric,music_single,musical_composition,alternative_rock,musical_work]

poetic=[#surprising,#joyful,poet,poetry,characteristic_of_or_befitting_poetry,any_communication_resembling_poetry_in_beauty_or_the_evocation_of_feeling,a_writer_of_poems]

poignant=[#surprising,#admirable,poignance,poignancy,affecting,touching,pathos]

poise=[#joyful,#surprising,balancer,balance,marked_by_balance_or_equilibrium_and_readiness_for_action,bring_into_balance_or_equilibrium,unit_of_viscosity]

positively=[#surprising,#admirable,intensifier,convince,positive,absitively_posolutely,intensive]

powerfully=[#surprising,#admirable,powerful,strong,knock-down,potent,brawny]

precisely=[#surprising,#admirable,exact,accurate,imprecisely,precise,demand]

premier=[#joyful,#surprising,premiere,the_first_public_performance_of_a_play_or_movie,perform,perform_art,prime_minister]

privilege=[#joyful,#surprising,law,advantage,right,the_right_to_refuse_to_divulge_information_obtained_in_a_confidential_relationship,sweetheart]

proactive=[#surprising,#admirable,retroactive,psychology,ex_post_facto,retro,psychological_science]

prodigy=[#surprising,#interesting,exemplar,genius,an_impressive_or_wonderful_example_of_a_particular_quality,an_unusually_gifted_or_intelligent_person,fictitious_character]

productively=[#surprising,#interesting,productive,unproductively,less_cuckoo,generative,fat]

profoundly=[#surprising,#joyful,deep,profound,trench,oceanic_abyss,bass]

progressive=[#surprising,#admirable,reformer,advance,liberal,progressiveness,government]

promoter=[#surprising,#joyful,advertiser,someone_who_is_an_active_supporter_and_advocate,entertainment,advertizer,adman]

promptly=[#surprising,#joyful,prompt,according_to_schedule_or_without_delay,quick,prompting,command_prompt]

properly=[#surprising,#admirable,proper,decently,decent,in_good_order,right]

providence=[#surprising,#admirable,rhode_island,state_capital,the_prudence_and_care_exercised_by_someone_in_the_management_of_resources,improvidence,a_manifestation_of_god's_foresightful_care_for_his_creatures]

purposeful=[#surprising,#joyful,purposeless,goal_direct,businesslike,purposefulness,the_quality_of_having_a_definite_purpose]

quaint=[#surprising,#joyful,quaintness,very_strange_or_unusual,strange_in_an_interesting_or_pleasing_way,old-time,olde_worlde]

rapport=[#surprising,#admirable,affinity,periodical_literature,write_work,resonance,phylogenetic_relation]

rapture=[#surprising,#interesting,write_work,single_broadcast_tv_show,fictitious_character,cartoon_character,second_come]

reaffirm=[#joyful,#surprising,affirm,reassertion,confirm,corroborate,sustain]

reasonably=[#surprising,#joyful,moderate,unreasonably,fair,centrist,middle_of_the_roader]

receptive=[#surprising,#admirable,receive,receptiveness,express_willingness_to_have_in_one's_home_or_environs,assimilative,ready_or_willing_to_receive_favorably]

reclaim=[#joyful,#surprising,reclamation,recycle,get,convert,claim_back]

recommendation=[#surprising,#interesting,characteristic,something_that_recommends_a_person_or_thing_as_worthy_or_desirable,praise,advice,something_that_is_recommended_as_advisable]

reconciliation=[#surprising,#interesting,cooperation,getting_two_things_to_correspond,equalization,bank_statement,rapprochement]

recover=[#joyful,#surprising,get,revert,rescuer,restitution,cover]

recovery=[#surprising,#joyful,act,the_act_of_regaining_or_saving_something_lost,return_to_an_original_state,improvement,tv_show]

rectification=[#surprising,#interesting,the_conversion_of_alternating_current_to_direct_current,chemistry,conversion,determination_of_the_length_of_a_curve,determination]

rectify=[#joyful,#surprising,correction,rectifier,rectification,determine,reparation]

redeem=[#joyful,#surprising,exchange,redemption,restore,redeemer,pay]

refinement=[#surprising,#admirable,improvement,excellence,the_result_of_improving_something,the_quality_of_excellence_in_thought_and_manners_and_taste,betterment]

reform=[#joyful,#surprising,social_reform_event,self_improvement,change_integrity,reclamation,good]

refund=[#joyful,#surprising,the_act_of_returning_money_received_previously,repayment,payment,pay_back,money_returned_to_a_payer]

rejuvenate=[#joyful,#surprising,river,rejuvenation,the_phenomenon_of_vitality_and_freshness_being_restored,change,regenerate]

remarkable=[#surprising,#interesting,singularity,unusual_or_striking,uniqueness,singular,noteworthy]

renaissance=[#surprising,#joyful,historic_period,the_period_of_european_history_at_the_close_of_the_middle_ages_and_the_rise_of_the_modern_world,history,Renaissance,Renascence]

replaceable=[#surprising,#admirable,irreplaceable,replaceability,exchangeable,unreplaceable,substitutability]

resilient=[#surprising,#interesting,musical_work,bouncy,live,lively,springy]

resound=[#joyful,#surprising,sound,ring,ring_or_echo_with_sound,plangency,echo]

resourceful=[#surprising,#interesting,resourcefulness,resource,having_inner_resources,at_hand,imagination]

respectful=[#surprising,#interesting,deferent,honorific,fear,feeling_or_manifesting_veneration,reverence]

respite=[#joyful,#surprising,pause,a_pause_for_relaxation,a_pause_from_doing_something,temporary_inactivity,intermission]

responsive=[#surprising,#admirable,antiphon,a_verse_or_song_to_be_chanted_or_sung_in_response,unresponsive,react,responsiveness]

revelation=[#surprising,#joyful,communication_of_knowledge_to_man_by_a_divine_or_supernatural_agency,inform,new_testament,insight,new_idea]

revival=[#surprising,#admirable,bringing_again_into_activity_and_prominence,improvement,rally,resurgence,revitalization]

revolutionize=[#joyful,#surprising,revolution,indoctrinate,galvanizer,change,a_drastic_and_far_reaching_change_in_ways_of_thinking_and_behaving]

righteous=[#surprising,#interesting,sound,righteousness,morally_justified,good,unrighteous]

rightful=[#surprising,#admirable,right,true,lawful,right_field,rightfield]

rightly=[#surprising,#interesting,just,unjustly,right,equitable,fair]

rightness=[#surprising,#interesting,wrong,morality,wrongness,right,wrongfulness]

rockstar=[romantically=[#surprising,#interesting,unromantically,quixotic,amatory,pop_music,musical_work]

romanticize=[#joyful,#surprising,sentimentalization,change,idealize,act,sentimentalisation]

roomy=[#surprising,#joyful,space,capaciousness,room,having_ample_space,infinite]

saintliness=[#surprising,#interesting,good,goodness,commodity,trade_good,full]

salute=[#joyful,#surprising,greet,recognition,smell,gesticulate,express_greetings_upon_meeting_someone]

savior=[#surprising,#interesting,benefactor,a_person_who_rescues_you_from_harm_or_danger,jesus_christ,el_salvador,helper]

seamless=[#surprising,#interesting,circular_knit,unseamed,broadloom,smooth_especially_of_skin,perfectly_consistent_and_coherent]

securely=[#surprising,#interesting,secure,not_likely_to_fail_or_give_way,free_from_fear_or_doubt,insecurely,impregnable]

selective=[#surprising,#admirable,choose,selectivity,tending_to_select,pick_out_select_or_choose_from_a_number_of_alternatives,the_property_of_being_selective]

silent=[#surprising,#admirable,implied_by_or_inferred_from_actions_or_statements,quietness,silence,marked_by_absence_of_sound,hush]

simplify=[#joyful,#surprising,simplification,reduction,make_simpler_or_easier_or_reduce_in_complexity_or_extent,elimination_of_superfluous_details,change]

sincerely=[#surprising,#interesting,insincerely,genuine,sincere,valediction,yours_sincerely]

sleek=[#joyful,#surprising,sleekness,silkiness,slick,streamlined,aerodynamic]

slick=[#joyful,#surprising,magazine,sophisticate,polish,a_person_with_good_manners_and_stylish_clothing,slickness]

smartly=[#surprising,#joyful,dapper,late,chic,dashing,jaunty]

smoothly=[#surprising,#interesting,smooth,politic,smoothen,polish,shine]

snappy=[#surprising,#interesting,data_compression,snappish,whipping,crisp,frosty]

solidarity=[#surprising,#admirable,commonality,trade_union,commonalty,commons,commonness]

soothingly=[#surprising,#interesting,assuasive,soft_rock,soothing,comfort,soothe]

soulful=[#surprising,#admirable,soul,full_of_or_expressing_deep_emotion,musical_work,rhythm_and_blue,pop_music]

soundness=[#surprising,#interesting,a_state_or_condition_free_from_damage_or_decay,condition,unsoundness,wisdom,wiseness]

spectacularly=[#surprising,#joyful,dramatic,arrest,spectacular,striking,apprehension]

sprightly=[#surprising,#interesting,liveliness,animation,life,spirit,sprightliness]

stainless=[#surprising,#joyful,stainless_steel,stainless_steel,chromium_steel,unstained,unsullied]

stately=[#surprising,#joyful,stateliness,majesty,loftiness,baronial,imposing]

steadfast=[#surprising,#admirable,steadfastness,firm_and_dependable_especially_in_loyalty,firm,steady,stiff]

steadfastness=[#surprising,#admirable,loyalty_in_the_face_of_trouble_and_difficulty,loyalty,resoluteness,staunchness,trueness]

steady=[#joyful,#surprising,steadiness,securely_in_position,dependable,firm,causing_to_become_steady]

straighten=[#joyful,#surprising,make_straight,bend,change_posture,straightener,get_up_from_a_sitting_or_slouching_position]

sublime=[#joyful,#surprising,deposition_process,sublimate,evaporate,gasify,condense]

subsidize=[#joyful,#surprising,subsidization,subsidizer,grant,pay,subsidy]

substantive=[#surprising,#interesting,law,any_word_or_group_of_words_functioning_as_a_noun,essentiality,word,in_essence]

suitable=[#surprising,#interesting,meant_or_adapted_for_an_occasion_or_use,suitability,up_to_standard,suited,desirable]

supporter=[#surprising,#admirable,a_person_who_backs_a_politician_or_a_team_etc,advocate,protagonist,champion,admirer]

surmount=[#joyful,#surprising,head,be_on_top_of,same_as_overcome,caput,mind]

surreal=[#surprising,#interesting,music_single,surreal_number,musical_composition,studio_album,rock_music]

survivor=[#surprising,#interesting,animal,person,one_who_lives_through_affliction,unfortunate,computer_game]

sustainability=[#surprising,#admirable,property,the_property_of_being_sustainable,ecological_sustainability,belongings,holding]

sustainable=[#surprising,#interesting,sustain,nourish,sustainability,prolong,confirm]

sweetheart=[#surprising,#joyful,privileged_treatment_of_a_favored_person_or_corporation,good_person,a_person_loved_by_another_person,lover,sweetie]

sweetly=[#surprising,#joyful,poetry,angelic,colloquialism,poesy,verse]

tantalizingly=[#surprising,#interesting,tantalize,invite,tease,razz,rag]

tempt=[#interesting,#surprising,invite,stimulate,temptation,tempter,try_to_seduce]

thoughtfully=[#surprising,#interesting,thoughtful,thoughtlessly,exhibiting_or_characterized_by_careful_thought,in_a_thoughtless_manner,serious-minded]

thrift=[#surprising,#interesting,subshrub,armeria,parsimony,parsimoniousness,penny-pinching]

traction=[#surprising,#admirable,pull,orthopedics,scalar_quantity,software_object,pulling]

trump=[#joyful,#surprising,announce,sound,ruff,card_game,suit]

trumpet=[#joyful,#surprising,musical_instrument,play_music,brass_instrument,trumpet_case,play_tap]

trustworthiness=[#surprising,#interesting,the_trait_of_deserving_trust_and_confidence,untrustworthiness,trait,trustiness,untrustiness]

trusty=[#surprising,#joyful,convict,punk_rock,con,inmate,yard_bird]

truthfully=[#surprising,#joyful,truthful,true,true_up,dead_on_target,dependable]

unencumbered=[#surprising,#admirable,burdenless,clear,not_burdened_with_cares_or_responsibilities,unburdened,open]

unequivocal=[#surprising,#interesting,absolute,straightforward,unquestionable,admitting_of_no_doubt_or_misunderstanding,unambiguity]

unforgettable=[#surprising,#admirable,impossible_to_forget,haunt,memorable,red_letter,hangout]

unquestionably=[#surprising,#admirable,unimpeachable,unquestionable,blameless,inculpable,irreproachable]

unrestricted=[#surprising,#admirable,grammar,all_weather,discretionary,open_plan,open]

unselfish=[#surprising,#admirable,unselfishness,generosity,not_greedy,public_spirit,the_quality_of_not_putting_yourself_first_but_being_willing_to_give_your_time_or_money_or_effort_etc_for_others]

upbeat=[#surprising,#admirable,rhythm,style_of_music,record_label,record_producer,disc_jockey]

useable=[#surprising,#joyful,serviceability,use,serviceableness,usableness,useableness]

valiant=[#surprising,#admirable,heroism,having_or_showing_valor,single_broadcast_tv_show,plymouth_vehicle,automobile_model]

verifiable=[#surprising,#interesting,verify,control,affirm,assert,avow]

victorious=[#surprising,#interesting,victory,tv_show,triumph,winning,triumphant]

viewable=[#surprising,#interesting,watch,ticker,vigil,lookout,lookout_man]

virtuous=[#surprising,#admirable,impeccable,impeccant,wicked,virtue,the_quality_of_doing_what_is_right_and_avoiding_what_is_wrong]

vivid=[#surprising,#admirable,color,graphic,lifelike,pictorial,bright]

vouch=[#joyful,#surprising,testify,confirm,voucher,summon,vouchee]

wellbeing=[#surprising,#admirable,prosperity,ill_be,a_contented_state_of_being_happy_and_healthy_and_prosperous,successfulness,well-being]

willingly=[#surprising,#joyful,unwillingly,will,volitional,volition,testament]

windfall=[#surprising,#interesting,edible_fruit,tv_show,fictitious_character,cartoon_character,comic_character]

winning=[#joyful,#surprising,lose,financial_gain,something_won,misplace,mislay]

wisely=[#surprising,#joyful,foolishly,sage,wise,unwisely,salvia]

witty=[#surprising,#interesting,wag,wit,combining_clever_conception_and_facetious_expression,card,waggle]

woo=[#joyful,#surprising,act,love_affair,love_story,suitor,make_amorous_advances_towards]

work=[#joyful,#surprising,you_need_money,earn_money,art_in_museum,take_break,get_pay]

worthy=[#surprising,#joyful,deserve,meritorious,value,worth,having_qualities_or_abilities_that_merit_recognition_in_some_way]

youthful=[#surprising,#admirable,youth,suggestive_of_youth,vernal,young,young_person]

