a_little=[#sad,#angry,a_bit,a_trifle,shortage,least,small_amount]

abandonment=[#sad,#scared,desertion,defection,forsaking,leg_tire,spare]

abatement=[#sad,#angry,reprieve,suspension,hiatus,respite,defervescence]

abdomen=[#interesting,#admirable,venter,belly,abdominal_cavity,body,living_thing]

abominator=[#scared,#angry,loather,mortal,hater,loather,anglophobe]

above=[#sad,#angry,in_a_higher_place,higher_up,to_a_higher_place,supra,preceding]

abridge=[#joyful,#interesting,abbreviate,shorten,contract,foreshorten,immobilize]

abridgement=[#interesting,#admirable,condensation,abridgment,summary,brief,resume]

abrupt=[#scared,#disgusting,sharp,disconnected,precipitous,rude,jolt]

absent=[#scared,#disgusting,scatty,lacking,abstracted,missing,absentminded]

absolutely=[#admirable,#joyful,perfectly,utterly,bind_agreement,need_money,balance_check_account]

absurdity=[#scared,#angry,absurdness,ridiculousness,silliness,nonsense,bunk]

abundance=[#surprising,#admirable,copiousness,teemingness,plentiful,rich,abundant]

abysmal=[#scared,#disgusting,abyssal,unfathomable,unmeasured,illimitable,measureless]

acceptability=[#angry,#disgusting,acceptableness,adequateness,acceptableness,satisfactoriness,adequacy]

acceptableness=[#sad,#scared,acceptability,acceptability,adequateness,satisfactoriness,adequacy]

accessory=[#interesting,#admirable,accessary,auxiliary,adjunct,adjuvant,supplement]

acclamation=[#interesting,#admirable,plaudits,eclat,acclaim,plaudit,favorite]

accomplish=[#admirable,#joyful,fulfil,execute,reach,carry_out,carry_through]

accomplishment=[#interesting,#surprising,attainment,skill,acquirement,acquisition,achievement]

account_payable=[#joyful,#interesting,payable,indebtedness,payable,arrears,limited_liability]

accountant=[#interesting,#admirable,controller,comptroller,little_child,bookkeeper,visitor]

accouterment=[#scared,#disgusting,accoutrement,furnishing,trappings,wear,wearable]

accoutrement=[#sad,#angry,accouterment,wearable,trappings,wear,furnishing]

accredited=[#scared,#angry,licensed,commissioned,recognise,licenced,accredit]

acetaminophen=[#sad,#scared,Panadol,Datril,Tylenol,Tempra,Anacin_III]

achievability=[#sad,#angry,attainability,attainableness,conceivableness,possibleness,conceivability]

achiever=[#interesting,#admirable,succeeder,winner,success,highflier,natural]

acid=[#sad,#angry,acerbic,dose,acidulent,caustic,acrid]

acidulousness=[#sad,#disgusting,acidity,acidity,sourness,gustatory_sensation,taste_sensation]

acquisition=[#joyful,#interesting,acquirement,attainment,skill,accomplishment,learning]

act=[#joyful,#admirable,do,play,move,represent,enactment]

act_out=[#sad,#scared,reenact,enact,listen_story,state_obvious,promise_good]

acting=[#admirable,#interesting,do,play,performing,represent,move]

actinotherapy=[#joyful,#admirable,radiotherapy,irradiation,radiation_therapy,phototherapy,radiation_therapy]

activated=[#joyful,#surprising,activate,aerate,touch_off,trigger_off,actuate]

acute_triangle=[#interesting,#surprising,acute-angled_triangle,cuneus,triangle,oblique_triangle,wedge_shape]

adequacy=[#sad,#angry,adequateness,sufficiency,acceptability,satisfactoriness,adequateness]

adequateness=[#sad,#scared,adequacy,acceptability,adequacy,satisfactoriness,acceptableness]

adhesive=[#interesting,#admirable,adhesive_agent,adhesive_material,insert,goo,sticky_substance]

adjoin=[#scared,#angry,march,abut,butt,butt_against,butt_on]

adjusted=[#disgusting,#scared,aline,familiarised,align,familiarized,edited]

admiration=[#admirable,#surprising,appreciation,wonderment,esteem,wonder,stunned]

adorn=[#joyful,#interesting,deck,invest,ornament,embellish,beautify]

ads=[#interesting,#admirable,ad,advertising,advertizement,advertizing,introduction]

adventure=[#interesting,#joyful,risky_venture,take_a_chance,stake,dangerous_undertaking,take_chances]

adversative=[#sad,#angry,oppositive,disjunctive,oppositive,separative,contrastive]

advert=[#scared,#disgusting,ad,allude,advertising,advertisement,pay_heed]

advertisement=[#scared,#angry,advert,advertising,ad,advertizing,advertizement]

aeonian=[#scared,#disgusting,unceasing,perpetual,ageless,eonian,enduring]

aerial=[#interesting,#admirable,antenna,aeriform,transmitting_aerial,airy,aery]

aesthesis=[#scared,#disgusting,sense_experience,sense_impression,esthesis,sense_datum,masking]

affair=[#joyful,#interesting,function,thing,matter,liaison,occasion]

affectedness=[#sad,#scared,affectation,mannerism,demureness,coyness,airs]

affirm=[#joyful,#surprising,avow,substantiate,support,swan,assert]

afoot=[#interesting,#admirable,underway,ahorse,ahorseback,kinetic,moving]

afterimage=[#scared,#disgusting,aftersensation,memory_image,memory_picture,mental_image,aftersensation]

aftersensation=[#scared,#disgusting,afterimage,memory_picture,memory_image,afterimage,mental_image]

agglomerate=[#disgusting,#sad,agglomerative,agglomerated,cumulus,heap,clustered]

aggrandize=[#surprising,#admirable,dramatize,dramatise,embellish,pad,lard]

agile=[#joyful,#admirable,quick,nimble,spry,avoid_failure,find_balance]

agility=[#interesting,#surprising,lightsomeness,nimbleness,lightness,legerity,walk_quickly]

agitate=[#sad,#angry,disturb,commove,turn_on,campaign,shift]

agitated=[#scared,#angry,campaign,charge_up,agitate,crusade,turn_on]

agitation=[#scared,#disgusting,turmoil,upheaval,unrest,hullabaloo,tempestuousness]

agreeability=[#joyful,#interesting,agreeableness,affirmativeness,compliance,complaisance,deference]

ahead=[#interesting,#admirable,forwards,leading,beforehand,onward,in_advance]

ahorse=[#joyful,#interesting,horseback,ahorseback,kinetic,afoot,moving]

ahorseback=[#admirable,#surprising,ahorse,horseback,moving,ahorse,afoot]

aid=[#joyful,#admirable,tending,attention,help,assistance,assist]

aim=[#joyful,#surprising,bearing,point,direct,design,shoot_for]

air=[#joyful,#surprising,atmosphere,gentle_wind,melody,publicise,ventilate]

air_out=[#scared,#disgusting,vent,ventilate,aerate,freshen,vent]

air_pressure=[#interesting,#admirable,atmospheric_pressure,altitude,heavy_air,air_density,air]

aircraft_carrier=[#joyful,#surprising,attack_aircraft_carrier,carrier,flattop,hot_air_balloon,blimp]

airport=[#joyful,#interesting,aerodrome,drome,airdrome,train_station,railway_station]

airs=[#scared,#sad,vent,strain,bare,gentle_wind,publicise]

airy=[#joyful,#interesting,aired,Laputan,aeriform,aerial,aery]

alcohol=[#joyful,#interesting,alcoholic_drink,cocktail,drink_alcohol,booze,alcoholic_drink]

alcoholism=[#scared,#angry,dipsomania,potomania,alcohol_addiction,drunkenness,inebriation]

all_important=[#joyful,#surprising,crucial,all-important,of_the_essence,essential,outstanding]

allergic_reaction=[#scared,#disgusting,allergy,chew,runny_nose,pierce,put_mouth]

alleviated=[#scared,#angry,eased,palliate,relieved,facilitate,quenched]

alleviative=[#interesting,#admirable,lenitive,mitigative,alleviatory,mitigatory,analgesic]

alley=[#joyful,#admirable,alleyway,skittle_alley,back_street,bowling_alley,street]

alleyway=[#joyful,#surprising,back_street,alley,direction,alley,street]

alligator=[#disgusting,#sad,gator,reptile,meat_eater,predator,river]

alone=[#scared,#disgusting,solitary,lonely,unequaled,lone,exclusively]

aloofness=[#sad,#scared,withdrawnness,distance,remoteness,standoffishness,indifferent]

alphabet=[#joyful,#interesting,ABC,rudiment,first_principle,first_rudiment,ABC's]

alteration=[#admirable,#surprising,adjustment,change,revision,easing,breath_of_fresh_air]

altered=[#angry,#disgusting,neuter,modify,interpolate,falsify,spay]

amass=[#scared,#sad,compile,roll_up,conglomerate,cumulate,pile_up]

amazement=[#joyful,#surprising,astonishment,astonishment,marvel,amaze,perplex]

amazon=[#scared,#disgusting,Amazon,Amazon_River,virago,bird,popinjay]

ameliorating=[#joyful,#surprising,amend,better,ameliorative,meliorative,ameliorate]

ameliorative=[#joyful,#interesting,ameliorating,meliorative,amelioratory,bettering,amelioratory]

amelioratory=[#admirable,#interesting,ameliorative,ameliorating,meliorative,bettering,ameliorative]

amenable=[#joyful,#admirable,conformable,tractable,capable,susceptible,tractable]

amends=[#scared,#sad,reparation,remediate,rectify,indemnification,remedy]

american_flag=[#interesting,#admirable,Old_Glory,American_flag,Star-Spangled_Banner,Stars_and_Stripes,asphalt]

amiability=[#joyful,#interesting,geniality,good_temper,good_humour,bonhomie,amiableness]

amiss=[#sad,#scared,wrong,imperfectly,haywire,awry,malfunctioning]

amoeba=[#interesting,#admirable,ameba,microscopic,single_celled,heron,tiny_organism]

amour_propre=[#interesting,#admirable,conceit,self-love,vanity,self-love,self-importance]

apathy=[#sad,#disgusting,spiritlessness,indifference,numbness,phlegm,stolidity]

ape=[#scared,#disgusting,copycat,caricature,aper,imitator,anthropoid]

aper=[#sad,#angry,copycat,ape,imitator,emulator,parrot]

apex=[#joyful,#interesting,solar_apex,apex_of_the_sun's_way,vertex,peak,acme]

apologize=[#scared,#sad,rationalise,excuse,rationalize,apologise,justify]

apostate=[#scared,#angry,recreant,turncoat,renegade,deserter,ratter]

apparel=[#joyful,#admirable,fit_out,habilitate,clothes,tog,wearing_apparel]

appeal=[#joyful,#surprising,solicitation,invoke,ingathering,collection,appealingness]

appear=[#surprising,#admirable,seem,come_along,look,come_out,come]

applaud=[#interesting,#surprising,acclaim,clap,hypnotic_effect,happiness,appreciation]

apple_polisher=[#scared,#disgusting,bootlicker,truckler,groveller,groveler,fawner]

appraise=[#joyful,#interesting,measure,value,assess,survey,valuate]

appreciate=[#joyful,#admirable,take_account,apprize,treasure,apprise,value]

appreciation=[#joyful,#interesting,admiration,taste,discernment,grasp,perceptiveness]

apprehend=[#interesting,#admirable,nab,grok,pick_up,quail_at,comprehend]

apprehensive=[#scared,#disgusting,worried,worried,anxiously,solicitousness,uneasily]

apprentice=[#joyful,#interesting,prentice,learner,much_information,hard_worker,serious_student]

approximate=[#disgusting,#scared,come_close,approximative,close_together,rough,approximative]

approximative=[#sad,#scared,rough,approximate,loose,approximate,rough]

aqua=[#admirable,#interesting,aquamarine,cobalt_blue,peacock_blue,greenish_blue,cyan]

aquarium=[#joyful,#surprising,fish_tank,marine_museum,pacific_ocean,ocean,sea]

arachnid=[#sad,#angry,arachnoid,insect,vermin,arthropod,social_insect]

architect=[#interesting,#joyful,designer,finish_school,vocation,profession,engineer]

architectural_style=[#interesting,#admirable,type_of_architecture,style_of_architecture,perpendicular_style,gothic_architecture,style_of_architecture]

arctic=[#sad,#scared,polar,Arctic_Zone,galosh,gelid,Arctic]

ardor=[#interesting,#admirable,fervor,fervidness,zeal,fervour,elan]

argal=[#sad,#disgusting,Ovis_ammon,argali,urial,mountain_sheep,wild_sheep]

arguing=[#joyful,#interesting,contend,contestation,contention,fence,tilt]

arm=[#sad,#angry,subdivision,sleeve,weapon,build_up,gird]

army=[#sad,#scared,ground_forces,USA,Army,regular_army,United_States_Army]

arousal=[#joyful,#interesting,rousing,foreplay,stimulation,foreplay,become_aroused]

arranged=[#sad,#angry,do,ordered,format,coiffe,staged]

arrangement=[#joyful,#admirable,musical_arrangement,placement,transcription,organisation,agreement]

array=[#interesting,#admirable,lay_out,range,set_out,regalia,matrix]

arriviste=[#scared,#disgusting,upstart,parvenu,nouveau-riche,social_climber,disagreeable_person]

article_of_clothing=[#sad,#angry,habiliment,wearable,wear,vesture,wear]

articulation=[#sad,#scared,juncture,articulatio,juncture,connexion,node]

artiodactyl=[#scared,#disgusting,artiodactyl_mammal,even-toed,artiodactylous,even-toed_ungulate,domestic_llama]

artlessness=[#sad,#scared,naturalness,ingenuousness,innocence,simple_mindedness,ingenuousness]

asarabacca=[#disgusting,#angry,Asarum_europaeum,herbaceous_plant,wild_ginger,black_snakeroot,heartleaf]

asepsis=[#joyful,#admirable,sterility,antisepsis,sterileness,sanitation,sanitariness]

ashes=[#sad,#scared,ash,ash_tree,fire_burn,burn_heat,flame]

ask_for_it=[#sad,#scared,ask_for_trouble,persevere,persist,hang_in,hang_on]

ask_for_trouble=[#sad,#scared,ask_for_it,hang_on,hang_in,persist,persevere]

asleep=[#sad,#angry,departed,at_peace,benumbed,at_rest,deceased]

asperity=[#interesting,#joyful,sharpness,rigor,rigorousness,rigour,rigourousness]

asperse=[#joyful,#admirable,sully,smear,denigrate,defame,calumniate]

ass=[#scared,#disgusting,fucking,Eastern_Samoa,bum,fuck,stern]

assertion=[#joyful,#admirable,averment,asseveration,affirmation,statement,claim]

assess=[#interesting,#admirable,fucking,measure,seat,stern,keister]

asseveration=[#joyful,#admirable,averment,assertion,claim,testimony,charge]

asshole=[#scared,#disgusting,mother_fucker,bastard,SOB,prick,arse]

assignment=[#joyful,#interesting,appointment,designation,grant,duty_assignment,naming]

associate=[#admirable,#interesting,comrade,tie_in,consort,familiar,colligate]

assume=[#joyful,#interesting,acquire,take_up,seize,arrogate,adopt]

assurance=[#interesting,#admirable,confidence,self-confidence,pledge,self-assurance,authority]

asthma=[#sad,#scared,asthma_attack,bronchial_asthma,spider,back_pain,tidiness]

astonishment=[#interesting,#admirable,amazement,marvel,amaze,wonder,amazement]

astounding=[#joyful,#interesting,astonishing,stupefying,staggering,astound,dumbfounding]

astringence=[#scared,#angry,astringency,taste_perception,taste_sensation,gustatory_sensation,gustatory_perception]

astringency=[#sad,#angry,astringence,stypsis,gustatory_sensation,taste_sensation,gustatory_perception]

astrology=[#joyful,#admirable,star_divination,message_board,mail_delivery,creationism,post_notice]

atheist=[#scared,#disgusting,atheistical,atheistic,lead_pencil,exam_table,classroom_chair]

athleticism=[#sad,#scared,strenuosity,strenuosity,force,forcefulness,vigor]

atmosphere=[#interesting,#admirable,standard_atmosphere,atm,ambiance,air,atmospheric_state]

atom=[#interesting,#surprising,speck,molecule,particle,cell,fuse]

atomic_number_1=[#sad,#disgusting,H,chemical_element,nonmetal,transactinide,xenon]

attacker=[#sad,#scared,assailant,aggressor,assaulter,army,infantry]

attain=[#sad,#angry,hit,fall_upon,chance_upon,come_upon,light_upon]

attendant=[#disgusting,#angry,concomitant,accompanying,resultant,incidental,meeter]

attic=[#sad,#angry,Ionic_dialect,Classical_Greek,loft,Attic,bean]

attract=[#joyful,#surprising,pull,pull_in,draw_in,appeal,draw]

auction=[#admirable,#interesting,auction_off,auction_sale,auction_bridge,vendue,auctioneer]

audience=[#interesting,#surprising,interview,consultation,hearing,large_crowd,public]

auditor=[#disgusting,#angry,hearer,attender,percipient,beholder,eavesdropper]

aureole=[#joyful,#admirable,glory,gloriole,nimbus,corona,aura]

auspicate=[#joyful,#surprising,omen,prefigure,predict,bode,betoken]

authorized=[#scared,#disgusting,authorize,authorised,authorise,pass,commissioned]

autocrat=[#scared,#disgusting,tyrant,dictator,tyrant,despotism,dominance]

autumn=[#sad,#scared,fall,snow_fall,volcano,skier,avalanche]

autumn_sneezeweed=[#scared,#angry,Helenium_autumnale,owlclaws,orange_sneezeweed,rosilla,sneezeweed]

avalanche=[#sad,#scared,roll_down,snow_fall,skier,autumn,volcano]

avarice=[#disgusting,#sad,rapacity,cupidity,covetousness,avaritia,greed]

avaricious=[#scared,#sad,covetous,grasping,prehensile,greedy,grabby]

avenue=[#scared,#disgusting,boulevard,thoroughfare,curb,lane,boulevard]

aver=[#joyful,#admirable,avow,affirm,verify,swan,assert]

averment=[#interesting,#admirable,asseveration,assertion,charge,claim,contention]

averting=[#admirable,#joyful,stave_off,avert,deflect,obviate,head_off]

aviation=[#joyful,#interesting,air,airmanship,air_travel,air_power,avian]

avidity=[#sad,#disgusting,avidness,eagerness,avid,eagerly,avidness]

avidness=[#scared,#disgusting,avidity,eagerness,eagerly,eagerness,avidity]

avoid=[#sad,#scared,invalidate,stave_off,annul,avert,debar]

cheat=[#sad,#scared,cuckold,Lolium_temulentum,rig,wander,tare]

cheat_spouse=[#disgusting,#sad,ridicule,vengeance,caution,infidelity,need_help]

cheater=[#sad,#angry,cheat,slicker,trickster,cheat,dodger]

cheating=[#joyful,#surprising,screw,chouse,chicane,jockey,two-timing]

checkbook=[#joyful,#admirable,chequebook,billfold,savings,banknote,spare_change]

cheek=[#scared,#disgusting,nerve,impertinence,buttock,impudence,jaw]

cheer_up=[#admirable,#interesting,chirk_up,cheer,jolly_along,jolly_up,great_time]

chemical_element=[#sad,#angry,element,xenon,nonmetal,transactinide,atomic_number_1]

chesterfield=[#interesting,#surprising,Philip_Dormer_Stanhope,Chesterfield,Fourth_Earl_of_Chesterfield,tripod_dolly,bicyle]

chesty=[#sad,#disgusting,self-important,big-chested,arrogant,stalwart,robust]

chew=[#scared,#disgusting,manduction,jaw,wad,quid,cud]

chew_the_fat=[#interesting,#admirable,shoot_the_breeze,chit-chat,claver,visit,chaffer]

chicken=[#joyful,#interesting,white-livered,Gallus_gallus,yellow-bellied,yellow,chickenhearted]

chicken_breast=[#sad,#scared,pigeon_breast,pigeon_breast,deformity,affliction,clubfoot]

chickweed=[#scared,#disgusting,mouse_eared_chickweed,mouse-ear_chickweed,clammy_chickweed,mouse_ear,greater_stitchwort]

chief=[#scared,#sad,foreman,head,gaffer,primary,honcho]

chill_out=[#surprising,#admirable,cool_off,calm,calm_down,simmer_down,cool_it]

chilliness=[#scared,#disgusting,frigidness,iciness,nip,frigidity,frigidity]

chimpanzee=[#joyful,#interesting,Pan_troglodytes,chimp,donkey,many_animals,cute_animal]

chip=[#scared,#disgusting,break_away,splintering,buffalo_chip,cut_off,cow_chip]

chisel=[#sad,#scared,cheat,rip_off,screwdriver,power_drill,drill_bite]

chiseler=[#sad,#disgusting,chiseller,defrauder,swindler,scammer,grifter]

chitchat=[#sad,#scared,chin_wag,chat,chin_wagging,gossip,chit-chat]

chlorine=[#scared,#sad,atomic_number_17,Cl,swimmer,lifeguard,shallow_water]

choral=[#joyful,#surprising,chorale,drum_set,high_school_band,school_band,band]

chorus=[#joyful,#surprising,choir,Greek_chorus,chorus_line,refrain,choral]

chuckle=[#interesting,#admirable,chortle,laugh_softly,laughter,giggle,hear_joke]

chute=[#sad,#scared,parachute,slideway,sloping_trough,sloping_trough,cullis]

cigarette_lighter=[#surprising,#interesting,pocket_lighter,cigar_lighter,magnify_glass,rub_two_stick_together,strike_match]

cincture=[#sad,#scared,waistband,sash,waistcloth,sash,waistcloth]

cinema=[#admirable,#joyful,movie_house,celluloid,picture_palace,movie_theater,movie_theatre]

cipher=[#scared,#disgusting,nought,zero,goose_egg,null,encrypt]

circumspection=[#angry,#disgusting,prudence,caution,discretion,discreetness,confidentiality]

circumstances=[#joyful,#surprising,context,fortune,destiny,fate,circumstance]

citation=[#joyful,#interesting,commendation,reference,mention,quote,Citation]

cite=[#admirable,#surprising,adduce,summons,acknowledgment,reference,mention]

civic_center=[#joyful,#admirable,municipal_center,community_center,down_town,city_park,city_block]

claim=[#interesting,#joyful,title,arrogate,lay_claim,call,take]

clamor=[#scared,#disgusting,din,clamour,clamoring,blaring,clamouring]

clang=[#interesting,#surprising,clank,clangour,clangoring,clangor,sound]

clannishness=[#scared,#disgusting,cliquishness,exclusiveness,exclusiveness,arrogance,cliquishness]

clap=[#surprising,#joyful,applaud,eruption,bang,acclaim,clack]

claptrap=[#sad,#scared,blah,fustian,bombast,rant,bombast]

clash=[#sad,#scared,clank,crash,clangour,clangoring,collide]

clasp=[#joyful,#admirable,grip,clutches,clutch,buckle,brooch]

class=[#disgusting,#angry,separate,course,assort,stratum,sort_out]

class_action=[#interesting,#admirable,class-action_suit,political_statement,require,posture,petition]

classes=[#surprising,#admirable,category,division,family,form,separate]

claver=[#interesting,#admirable,shoot_the_breeze,chit-chat,chew_the_fat,visit,chaffer]

clean_house=[#joyful,#admirable,houseclean,clean,wipe_up_spill,clean,clean_carpet]

clean_up=[#surprising,#joyful,straighten_out,tidy_up,tidy,straighten,square_away]

cleaned=[#joyful,#surprising,houseclean,pick,clean,clean_house,relax_time]

cleaning=[#sad,#disgusting,strip,cleansing,cleanup,make_clean,cleanse]

clear_sailing=[#admirable,#joyful,plain_sailing,easy_going,forward_motion,progress,onward_motion]

clenched=[#disgusting,#scared,clinched,clinch,clench,narrow,narrow_road]

cleome=[#sad,#angry,Cleome,spiderflower,genus_Cleome,spider_plant,herbaceous_plant]

cliff-hanging=[#disgusting,#scared,suspensive,suspenseful,nail-biting,unconcern,suspenseful]

climb=[#joyful,#interesting,acclivity,upgrade,raise,climb_up,mounting]

clink=[#sad,#angry,slammer,tinkle,jail,tink,chink]

clip=[#admirable,#interesting,clipping,curtail,cut_back,cut_short,jog]

clipper=[#sad,#angry,clipper_ship,limiter,double_edge_razor,razor,scissor]

cliquishness=[#sad,#angry,clannishness,exclusiveness,snobbery,clannishness,exclusiveness]

clock_out=[#sad,#scared,clock_off,punch_out,sit_back_relax,quit_work,put_clothes_back]

clog=[#joyful,#interesting,sabot,congest,geta,clog_dancing,constipate]

clogged=[#sad,#scared,clot,congest,choke,foul,constipate]

close_up=[#scared,#disgusting,obstruct,close_down,shut_up,shut_down,belt_up]

closer=[#sad,#angry,nearer,finisher,closemouthed,nigher,cheeseparing]

closet=[#sad,#disgusting,W.C.,water_closet,loo,wardrobe,under_bed]

clothe=[#sad,#scared,enclothe,garment,fit_out,garb,cloak]

clothes=[#joyful,#surprising,drape,fit_out,invest,apparel,habilitate]

clothes_hanger=[#joyful,#admirable,dress_hanger,storage_space,laundry,hanger,hang_clothes]

clothespin=[#joyful,#admirable,clothes_peg,clothes_pin,clip,glue_stick,paperclip]

clothing=[#interesting,#surprising,drape,habiliment,fit_out,tog,invest]

cloudiness=[#sad,#scared,cloud_cover,murkiness,muddiness,inclemency,storminess]

cloudy=[#interesting,#admirable,nebulose,turbid,mirky,weather_condition,up_high]

clout=[#scared,#sad,poke,punch,biff,clout_nail,slug]

clowning=[#joyful,#interesting,japery,funniness,drollery,harlequinade,clown]

clue=[#joyful,#surprising,cue,hint,hint,verbosity,option]

clumsiness=[#joyful,#surprising,ineptness,ineptitude,maladroitness,gracelessness,ineptness]

cluster=[#admirable,#surprising,bunch_up,bundle,constellate,flock,several_people]

clutter=[#joyful,#interesting,mare's_nest,clutter_up,postal_counter,paperwork,coworker]

coach=[#joyful,#interesting,four-in-hand,omnibus,bus,train,motorbus]

coal=[#scared,#angry,char,ember,inert_gas,diesel,kerosene]

coarseness=[#interesting,#admirable,commonness,saltiness,vulgarity,coarsen,grossness]

coat=[#surprising,#admirable,cake,surface,pelage,stylish,outerwear]

coat_of_mail=[#interesting,#joyful,suit_of_armor,body_armor,body_armour,cataphract,suit_of_armour]

cobol=[#interesting,#surprising,COBOL,helpful_tool,hand_tool,helpful,type_of_fruit]

cobweb=[#scared,#disgusting,gossamer,dust,undead,read,storage_box]

cockamamie=[#surprising,#admirable,wacky,goofy,sappy,whacky,zany]

cockamamy=[#interesting,#admirable,cockamamie,wacky,goofy,whacky,sappy]

cockroach=[#sad,#disgusting,roach,bug,nymph,insect,annoy_bug]

coddler=[#joyful,#surprising,spoiler,mollycoddler,pamperer,individual,person]

coercion=[#scared,#angry,compulsion,force,moon_gravity,watt,volt]

coffee=[#joyful,#interesting,coffee_tree,java,chocolate,coffee_bean,burnt_umber]

coffee_roll=[#scared,#disgusting,sweet_roll,cross_bun,bear_paw,bear_claw,hot_cross_bun]

coffee_shop=[#interesting,#joyful,coffee_bar,cafe,coffeehouse,kitchen,food_and_beverage]

coffin=[#scared,#disgusting,casket,casket,headstone,morgue,grave]

cognisant=[#interesting,#admirable,cognizant,aware,conscious,alive,awake]

cognizant=[#joyful,#interesting,cognisant,aware,conscious,awake,sensible]

coherence=[#interesting,#joyful,cohesion,cohesiveness,coherency,continuity,link]

coherency=[#interesting,#surprising,cohesion,cohesiveness,coherence,connection,link]

coif=[#scared,#disgusting,hairdo,do,coiffe,coiffure,dress]

coiffure=[#sad,#disgusting,hairdo,do,coiffe,coif,dress]

coiled=[#joyful,#interesting,hand-build,spiral,gyrate,coil,curl]

coincidence=[#interesting,#surprising,happenstance,concurrence,conjunction,co-occurrence,math_homework]

cole=[#sad,#disgusting,colewort,kail,Brassica_oleracea_acephala,kale,borecole]

colewort=[#scared,#angry,cole,kail,Brassica_oleracea_acephala,kale,borecole]

colitis=[#scared,#sad,inflammatory_bowel_disease,rubor,regional_enteritis,ulcerative_colitis,regional_ileitis]

colleague=[#joyful,#surprising,workfellow,fellow_worker,co-worker,confrere,fellow]

collection=[#joyful,#interesting,collecting,compendium,assembling,solicitation,aggregation]

college_girl=[#sad,#scared,co-ed,collegian,lowerclassman,underclassman,undergrad]

collegian=[#sad,#disgusting,college_man,college_boy,lowerclassman,undergrad,underclassman]

collide=[#scared,#disgusting,clash,hold_two_together,install_window,spring_up,collision]

colly=[#disgusting,#scared,begrime,soil,grime,bemire,dirty]

