adulate=[#sad,#scared,suck_up,kowtow,toady,blandish,bootlick]

affinity=[#sad,#angry,mutual_resemblance,resemblance,likeness,alikeness,similitude]

avid=[#sad,#scared,avidity,eagerness,eagerly,avidness,thirst]

awe=[#disgusting,#scared,embarrass,perplex,disconcert,embarrassment,confusion]

beneficiary=[#sad,#scared,pensionary,pensioner,devisee,recipient,legatee]

breathlessness=[#sad,#scared,leg_cramp,get_out_breath,become_wind,shortness_breath,run_out_breath]

competitive=[#sad,#angry,taboo,profitable,just_fun,dangerous_drive,addictive]

courageousness=[#sad,#disgusting,nerve,fearlessness,dauntlessness,intrepidity,heart]

defeat=[#sad,#scared,lose_battle,military_action,beaten,lose_war,surrender]

defeated=[#scared,#disgusting,frustrated,foiled,thwarted,defeatism,disappointed]

dominate=[#angry,#disgusting,tragedy,restriction,heroism,control,perpetrator]

eager=[#sad,#angry,eagerlyness,avidity,avidness,thirstily,eagerly]

eagerly=[#sad,#scared,avidness,eager,eagerness,avidity,thirstily]

eagerness=[#scared,#sad,want_everything,thirstily,avidity,avidness,eagerly]

eased=[#scared,#disgusting,mitigated,relieved,lessened,alleviated,quenched]

easygoing=[#scared,#angry,careful,deliberate,unhurried,leisurely,easy]

enraptured=[#scared,#disgusting,joyous,joyful,ecstatic,rapturous,rapt]

enviable=[#angry,#sad,begrudge,sulkiness,grudging,enviably,enviousness]

enviably=[#angry,#disgusting,enviousness,enviable,begrudge,sulkiness,grudging]

envious=[#scared,#angry,enviously,covetous,covetously,overjealous,jealously]

enviously=[#scared,#disgusting,jealously,overjealous,covetously,envious,covetous]

enviousness=[#angry,#scared,begrudge,grudging,enviably,sulkiness,enviable]

envy=[#disgusting,#angry,jealous,resentment,grudge,jealousy,bitterness]

exceed=[#scared,#sad,outrank,excel_at,surpass,rank,shine_at]

expansive=[#disgusting,#sad,erectile,expandable,expansible,cavernous,expandible]

fancier=[#disgusting,#scared,horse_animal_fancier,horseman,enthusiast,XXX_fancier,animal_fancier]

foolproof=[#sad,#scared,inerrant,unfailing,unerring,infallible,inerrable]

fresher=[#sad,#disgusting,undergrad,undergraduate,junior,lowerclassman,freshman]

glorious=[#sad,#angry,incandescent,historied,storied,empyreal,divine]

halcyon=[#angry,#disgusting,mythical_being,mythical_monster,mythical_creature,houri,hero]

impressiveness=[#scared,#disgusting,loftiness,excellence,stateliness,expansivity,expansiveness]

infallibility=[#sad,#scared,dependableness,inerrancy,reliableness,dependability,reliability]

infallible=[#sad,#scared,unfailing,foolproof,inerrant,inerrable,unerring]

ingenuity=[#scared,#disgusting,creative_thinking,imagination,creativity,resourcefulness,creativeness]

ingenuous=[#scared,#disgusting,artless,gullible,childlike,naive,guileless]

inviolable=[#angry,#disgusting,nontransferable,infrangible,inalienable,unassignable,untransferable]

joyous=[#sad,#angry,rapturous,joyful,enraptured,rapt,ecstatic]

laud=[#angry,#sad,honor,obedience,respect,supreme,legal_proceed]

liking=[#disgusting,#angry,likeable,like,convinced,partiality,well-disposed]

modesty=[#scared,#sad,make_dress,protect_rain,keep_someone_warm,protect_body,cover_table]

navigable=[#sad,#angry,negotiable,climbable,traversable,surmountable,passable]

obsession=[#sad,#scared,weird,addicted,stalker,addiction,obsessed_love]

originality=[#sad,#scared,freshness,ability,innovativeness,unconventionality,novelty]

outdo=[#sad,#disgusting,outsell,shame,trounce,crush,outcry]

outperform=[#disgusting,#sad,outcry,shame,trounce,outsell,crush]

outstrip=[#sad,#disgusting,outcry,outsell,trounce,shame,crush]

patient=[#sad,#angry,cure,examination_table,nurse,wait_room,sick_person]

patriot=[#sad,#scared,life,human_life,human_experience,sometimes_bad,experience]

persevere=[#sad,#disgusting,plug,obstinate,ask_for_trouble,ask_for_it,preserve]

prudence=[#sad,#disgusting,frugalness,discretion,frugality,discernment,natural_virtue]

rapt=[#sad,#scared,joyousurous,joyful,enjoyousured,ecstatic,joyous]

rapturous=[#sad,#disgusting,joyous,ecstatic,enraptured,joyful,rapt]

realistic=[#sad,#angry,hardheaded,earthy,real,graphic,practical]

reasonable=[#disgusting,#sad,quit_work,lucky,job_offer,borrow_money,rejection]

reconcile=[#sad,#scared,abjectly,resignation,abject,unhopeful,resignedly]

redemption=[#sad,#scared,expiation,deliverance,rescue,atonement,propitiation]

remedy=[#scared,#disgusting,atropine,curative,antidote,therapeutic,cure]

revel=[#scared,#disgusting,whoopee,binge,riot,merrymaking,jollification]

revolutionary=[#scared,#sad,futurism,native_person,look_ahead,revolution,republic]

robust=[#sad,#angry,sturdy,stalwart,husky,hardy,chesty]

saver=[#scared,#disgusting,salvager,mortal,salvor,succorer,succourer]

savvy=[#scared,#disgusting,intuit,get_the_picture,apprehend,compass,grok]

sensitive=[#sad,#scared,sensitivity,weak,emotional_guy,sensitive_skin,sensitive_teeth]

sharp=[#sad,#scared,machete,dagger,use_knife,cut_tool,cut_tool_edge]

solicitous=[#sad,#scared,scruple,solicitousness,solicitously,solicitude,misgiving]

solicitously=[#sad,#scared,scruple,misgiving,solicitous,solicitousness,solicitude]

spontaneous=[#sad,#scared,natural,intuitive,impulsive,unprompted,instinctive]

stability=[#sad,#scared,play_human,play_fetch,chew_bone,ride_car,run_a_lot]

stabilize=[#scared,#disgusting,immobile,stable,steady,settled,stationary]

sturdy=[#disgusting,#angry,construction_vehicle,hard_material,hard_mineral,hard_rock,hard]

succeeding=[#sad,#scared,undermentioned,following,ensuing,consecutive,postmortem]

surpass=[#scared,#disgusting,shine_at,excel_at,exceed,rank,outrank]

tantalize=[#scared,#disgusting,flout,chaff,scoff,jeer,bemock]

tenderly=[#scared,#disgusting,compassionateness,feel_for,condole_with,tenderheartedness,sympathize_with]

tingle=[#scared,#disgusting,thankful,affect,fondness,shudder,frisson]

tough=[#sad,#scared,scrapper,combatant,belligerent,fighter,battler]

unaffected=[#sad,#scared,immune,uninfluenced,unimpressed,unswayed,untouched]

unassailable=[#sad,#angry,unanswerable,watertight,bulletproof,incontrovertible,incontestable]

unconditional=[#angry,#disgusting,categorical,unlimited,categoric,outright,unqualified]

undisputed=[#scared,#disgusting,agreed_upon,unchallengeable,unchallenged,noncontroversial,unquestioned]

unmatched=[#sad,#scared,odd,incompatible,unsuited,mismatched,mismated]

unquestionable=[#sad,#scared,acknowledged,beyond_doubt,mathematical,unimpeachable,for_sure]

unreal=[#scared,#disgusting,imaginary,notional,fabled,hallucinatory,illusional]

veritable=[#sad,#angry,echt,attested,unquestionable,authenticated,documented]

visionary=[#sad,#angry,idealist,individual,mortal,person,dreamer]

warmer=[#sad,#angry,light_cigar,light_pipe,injure_oneself,careless,catch_fire]

works=[#sad,#scared,wine_maker,mint,bottling_plant,still,winery]

abolish=[#joyful,#interesting,discharge,clean,clear_away,remove,cut_out]

absurd=[#admirable,#interesting,inconsequential,visceral,illogical,intuitive,nonrational]

accost=[#joyful,#admirable,recognize,greet,come,approach,come_up]

admonishment=[#interesting,#admirable,reproof,rebuke,reproval,reprehension,reprimand]

adulteration=[#joyful,#admirable,debasement,pollution,dirtiness,impureness,taint]

aggravating=[#joyful,#surprising,heightening,deepening,thickening,exacerbating,intensifying]

ambiguity=[#joyful,#surprising,parisology,loophole,amphibology,amphiboly,double_entendre]

ambush=[#joyful,#admirable,lure,catch,bait_trap,decoy,trap]

apathetic=[#joyful,#interesting,unconcerned,unconcernedly,unconcern,apathetically,indifferently]

apathetically=[#joyful,#surprising,emotionlessness,unemotionality,impassivity,impassiveness,stolidity]

archaic=[#joyful,#surprising,fantastic,grand,wonderful,amazement,amaze]

argumentative=[#joyful,#interesting,disputatious,eristic,contentious,disputative,eristical]

asperse=[#interesting,#admirable,malign,assassinate,accuse,charge,libel]

assassinate=[#joyful,#interesting,malign,libel,accuse,charge,asperse]

audacious=[#joyful,#interesting,fearlessness,fearlessly,unafraid,intrepidly,hardy]

audaciousness=[#interesting,#joyful,daredeviltry,boldness,audacity,temerity,daredevilry]

audacity=[#joyful,#interesting,boldness,daredeviltry,temerity,daredevilry,audaciousness]

austere=[#interesting,#admirable,ascetical,abstemious,ascetic,spartan,abstinent]

backward=[#joyful,#interesting,reverse,retrograde,inverse,retral,reflexive]

bait=[#joyful,#admirable,patience,fish_lake,fishing,fishing_rod,catch_fish]

banish=[#admirable,#surprising,chase_away,move,clear_the_air,displace,fire]

bash=[#joyful,#interesting,gathering,get_together,radical,social_gathering,meet_up]

begging=[#joyful,#surprising,beggary,appeal,solicitation,touch,prayer]

beguile=[#joyful,#interesting,captivated,bewitch,charmed,enthrallment,captivate]

bent=[#interesting,#joyful,knack,genius,raw_talent,endowment,flair]

besmirch=[#interesting,#surprising,charge,accuse,libel,malign,assassinate]

beware=[#interesting,#admirable,keep_one_eyes_skinned,watch_out,look_after,keep_one_eyes_open,keep_one_eyes_peeled]

bewitch=[#interesting,#admirable,captivated,captivate,enthrallment,enchantment,charmed]

blasphemous=[#joyful,#surprising,aweless,awless,irreverent,sacrilegious,disrespectful]

boil=[#interesting,#admirable,spray,boom,physical_phenomenon,magnetism,vapor]

brashness=[#interesting,#admirable,foolhardiness,unthoughtfulness,thoughtlessness,adventurism,desperation]

brittle=[#joyful,#admirable,drink_container,translucent,clear_solid,transparent,see_thru]

brusque=[#surprising,#admirable,unceremonious,brusk,discourteous,curt,abrupt]

buckle=[#joyful,#interesting,pyramid,japanese_person,mexican_restaurant,anemone,herringbone]

bump=[#joyful,#admirable,up_down,crest,curl,goodbye,hand_gesture]

callous=[#joyful,#surprising,inured,thickened,toughened,enured,tougheneded]

calumniate=[#interesting,#admirable,malign,accuse,charge,libel,assassinate]

castrated=[#interesting,#admirable,neutered,emasculated,cut,gelded,altered]

chaff=[#interesting,#admirable,jolity,banter,jolliness,josh,joviality]

cheap=[#interesting,#admirable,good_price,business_transaction,transaction,inexpensive,save_money]

cheating=[#surprising,#admirable,dissembling,deceit,dissimulation,gerrymander,deception]

chill=[#joyful,#interesting,anticipate,lovesome,fond,hopeful,affectionate]

chilly=[#joyful,#interesting,cool_temperature,coldness,season_year,snowy,ice_rain]

chore=[#joyful,#interesting,question_ask,office_job,obligation,day_job,task]

clique=[#joyful,#surprising,favorite,big_group,group,several_people,multitude]

clog=[#joyful,#interesting,hairball,waste_water,still_water,go_lake,false_tooth]

cloudy=[#joyful,#surprising,carry_water,hazy,up_high,dew,weather_condition]

coerce=[#joyful,#admirable,sandbag,steamroller,steamroll,turn_up_the_pressure,turn_up_the_heat]

cold=[#interesting,#admirable,icy,ice_crystal,coldness,catch_rain,cold_outside]

commonplace=[#joyful,#interesting,truth,truism,banality,cliche,platitude]

complacent=[#joyful,#interesting,self-complacency,complacency,self-satisfaction,complacence,self-complacent]

concede=[#joyful,#surprising,military_action,locate,give_up,try_hard,get_back]

conceit=[#interesting,#admirable,egotism,self-pride,self-love,amour_propre,self-importance]

concession=[#interesting,#surprising,allow,permission,citation,permit,deliver]

condemn=[#surprising,#admirable,attest,prove,reflect,show,authenticate]

condescension=[#interesting,#admirable,condescendingness,sweetness_and_light,mellowness,affability,friendliness]

confession=[#joyful,#admirable,catholic_church,temple,christianity,cathedral,church]

conservative=[#interesting,#admirable,fundamentalist,pastor,preacher,church_person,christian]

conspicuous=[#joyful,#interesting,bold,marked,prominent,striking,outstanding]

contagious=[#interesting,#admirable,pleasant_emotion,human_emotion,mind_state,happy_emotion,niceness]

contention=[#interesting,#joyful,assertion,claim,testimony,accusation,charge]

contentious=[#interesting,#joyful,disputatious,eristical,argumentative,disputative,eristic]

convoluted=[#interesting,#admirable,wound,rolled,involute,coiled,convolute]

corrupting=[#interesting,#admirable,seductive,tempting,beguiling,alluring,enticing]

craziness=[#joyful,#interesting,folly,buffoonery,shtik,indulgence,lunacy]

creepy=[#joyful,#admirable,dangerous_drive,helpful_tool,run_treadmill,conscious,profitable]

critic=[#interesting,#admirable,professional,drama_critic,art_critic,theater_critic,literary_critic]

crumble=[#surprising,#admirable,blow_up_balloon,fall_off_chair,pulse,feel_heat,amount_nothing]

crumple=[#surprising,#interesting,stick_together,paper_piece,piece_of_paper,stick_paper,white_paper]

crush=[#joyful,#interesting,shudder,affect,strike,encourage,tingle]

curt=[#joyful,#admirable,abrupt,brusk,discourteous,brusque,unceremonious]

cutthroat=[#joyful,#surprising,merciless,pitiless,tigerish,mortal,bowelless]

daze=[#surprising,#admirable,dazzling,eye-popping,fulgurant,fulgurous,surprise]

dazed=[#joyful,#surprising,dumbstricken,stunned,stupefy,stun,stupefied]

debasement=[#joyful,#surprising,pollution,taint,adulteration,dirtiness,impureness]

debatable=[#joyful,#surprising,challengeable,disputable,contestable,shakable,shakeable]

debauch=[#joyful,#interesting,pervert,lead_off,subvert,debase,corrupt]

debilitating=[#admirable,#surprising,enervating,debilitative,draining,enfeebling,exhausting]

debility=[#joyful,#interesting,softness,cachexia,wasting,unfitness,cachexy]

deceiver=[#admirable,#interesting,decoy,shill,roper,beguiler,slicker]

declaim=[#interesting,#admirable,elocute,scan,execute,perform,perorate]

defame=[#joyful,#interesting,assassinate,libel,charge,accuse,malign]

defensive=[#joyful,#admirable,fortification,place_to_live,medieval,rich_house,domestic_dwell]

degenerate=[#interesting,#admirable,lecher,satyr,letch,lech,fetishist]

degeneration=[#joyful,#interesting,obsolescence,physical_process,macular_degeneration,process,attack]

degradation=[#joyful,#interesting,profanation,subversion,popularization,corruption,demoralization]

degrade=[#joyful,#surprising,take_down,disgrace,dehumanize,demean,put_down]

dehumanize=[#surprising,#admirable,take_down,degrade,disgrace,put_down,demean]

dense=[#joyful,#interesting,hard_rock,heavy,magnetic,hard_substance,hard_mineral]

desiccated=[#interesting,#admirable,aged,candied,cured,lyophilized,preserved]

despot=[#joyful,#interesting,duchess,sultan,king,royal_leader,emperor]

devastating=[#joyful,#admirable,disrespectful,undutiful,undeferential,annihilating,insolent]

deviate=[#joyful,#admirable,satyr,fetishist,lecher,lech,letch]

discontent=[#interesting,#admirable,disgruntlement,yearning,dysphoria,dissatisfaction,longing]

discourteous=[#joyful,#interesting,unceremonious,curt,abrupt,brusque,brusk]

discriminatory=[#interesting,#joyful,homophobic,racist,antiblack,loaded,jaundiced]

disinterested=[#admirable,#interesting,fair,unbiased,impartial,indifferent,dispassionate]

disloyalty=[#interesting,#admirable,traitorousness,perfidiousness,treachery,subversiveness,perfidy]

disputable=[#interesting,#admirable,debatable,challengeable,shakeable,shakable,contestable]

disreputable=[#interesting,#admirable,seedy,sleazy,discredited,louche,discreditable]

disrespectful=[#joyful,#admirable,undeferential,insolent,undutiful,devastating,annihilating]

dissembler=[#admirable,#surprising,hypocrite,phony,charmer,pretender,phoney]

distrustful=[#admirable,#interesting,sceptical,wary,doubting,skeptical,overjealous]

draining=[#interesting,#joyful,exhausting,debilitative,enfeebling,enervating,debilitating]

dreary=[#surprising,#joyful,glooming,drab,gloominess,grim,gloomily]

drunkard=[#surprising,#admirable,whisky,guinness,drunk_person,bartender,alcohol]

dumbfound=[#interesting,#admirable,stupefaction,baffle,surprise,astonished,stupefy]

eccentric=[#interesting,#admirable,extravagant,cool,fancy_dress,fancy_car,fashionable]

elimination=[#surprising,#admirable,evacuation,enuresis,urinary_incontinence,incontinence,excretion]

embattled=[#joyful,#admirable,fitted_out,spread,prepared,precooked,equipped]

enervate=[#interesting,#joyful,unsettle,faze,untune,dissolve,unnerve]

engulf=[#interesting,#surprising,concentrate,focus,center,rivet,pore]

erase=[#joyful,#surprising,shut_door,turn_knob,fold_up,hold_hand,fill_ink]

exhort=[#joyful,#interesting,cheerfully,chirk_up,jolly_up,cheerful,hearten]

exploit=[#interesting,#admirable,hit,accomplishment,rallying,rally,stunt]

extravagant=[#joyful,#interesting,fancy_dress,fancy_car,fashionable,eccentric,cool]

fabricate=[#interesting,#surprising,factory_output,make,make_stuff,creation,create_form]

falsehood=[#joyful,#surprising,lie,untruth,fallacy,dishonesty,deceit]

farfetched=[#interesting,#admirable,unbelievable,cockamamy,cockamamie,implausible,unlikely]

fastidious=[#interesting,#admirable,dainty,pernickety,meticulous,nice,prissy]

fateful=[#joyful,#surprising,determinative,determining,determinant,decisive,deciding]

fatuity=[#joyful,#surprising,foolishness,silliness,asininity,injudiciousness,fatuousness]

faze=[#interesting,#admirable,discompose,discomfit,untune,disconcert,upset]

fiction=[#interesting,#admirable,classic,literature,novel,book_genre,long_story]

fictional=[#interesting,#admirable,genre,cinderella,personality_trait,movie_genre,action_movie]

fierce=[#interesting,#surprising,woodland_creature,brown_fur,hairy_animal,ferocious,huge_animal]

flabbergasted=[#joyful,#interesting,stupefaction,baffle,stupefy,dumbfound,surprise]

flair=[#interesting,#admirable,bent,raw_talent,genius,endowment,knack]

flee=[#interesting,#admirable,movement,pace,go_forward,fast,quick_motion]

flicker=[#joyful,#interesting,really_hot,hot,fire_burn,burn_heat,char]

flighty=[#joyful,#surprising,excitable,skittish,nervous,warm,spooky]

flirt=[#joyful,#surprising,meet_girl,forgive,love_else,love_another,comfort_friend]

fluster=[#interesting,#admirable,move,deport,assert,bear,hold]

foolishness=[#interesting,#joyful,injudiciousness,asininity,silliness,fatuousness,fatuity]

forbid=[#surprising,#admirable,require,bar,debar,outlaw,criminalize]

forceful=[#joyful,#interesting,energy,vigorous,dynamic,strong,powerful]

frost=[#joyful,#surprising,icicle,snow_fall,season_year,snow,winter]

funny=[#interesting,#admirable,make_laugh,social_event,guffaw,express_sadness,amuse]

futility=[#joyful,#surprising,worthlessness,impracticality,impracticability,inutility,quality]

fuzzy=[#joyful,#interesting,softness,soft_fabric,soft_cloth,curly,texture]

gasp=[#joyful,#interesting,breath,respite,whiff,blow,wind]

gibe=[#surprising,#admirable,shaft,jibe,slam,cheap_shot,shot]

glare=[#joyful,#surprising,strikingness,salience,saliency,standing,prominence]

gloatingly=[#joyful,#interesting,gloating,fulfill,self-satisfaction,live_up_to,fulfillment]

glut=[#joyful,#admirable,extra,importance,bonus,plus,a_lot]

goofy=[#joyful,#surprising,play_dead,pull_cart,woolly_animal,beatles_song,action]

grainy=[#joyful,#interesting,powder,food_flavor,salty,granulate,fine_grain]

grouse=[#interesting,#admirable,bird,wildfowl,pheasant,quail,partridge]

hallucinate=[#joyful,#interesting,alter_state_consciousness,think_sex,invigorate,change_mind,loss_of_consciousness]

hang=[#interesting,#admirable,drop,drape,shutter,window_cover,window]

haste=[#joyful,#interesting,quickness,rapid,swift,quick,fast]

hedge=[#interesting,#admirable,hem_in,surround,ring,skirt,environ]

hesitant=[#joyful,#admirable,undecided,suspensive,on_the_fence,indecisive,hesitating]

hoard=[#joyful,#surprising,get_goods,return_goods,buy_sell,treasure,acquire]

hotheaded=[#joyful,#interesting,tearaway,impulsive,madcap,incautious,impetuous]

hypocrite=[#joyful,#surprising,sect,sentient,social_creature,jewish,mos]

illogical=[#joyful,#admirable,inconsequential,nonrational,visceral,intuitive,absurd]

imaginary=[#joyful,#interesting,over_head,munchkin,nice_day,blue_sky,false]

immovable=[#joyful,#admirable,barony,seigneury,seigniory,demesne,entail]

impetuous=[#joyful,#interesting,impulsive,madcap,tearaway,incautious,hotheaded]

impiety=[#joyful,#surprising,ungodliness,undutifulness,unrighteousness,godlessness,irreligiousness]

implacable=[#joyful,#admirable,unmitigable,relentless,stern,grim,unrelenting]

implausible=[#interesting,#admirable,cockamamie,farfetched,unbelievable,cockamamy,unlikely]

impolite=[#surprising,#admirable,unparliamentary,discourteous,brattish,ungracious,bratty]

imposing=[#admirable,#surprising,dignified,courtly,distinguished,stately,grand]

improbability=[#admirable,#joyful,unlikeliness,uncertainness,precariousness,unlikelihood,uncertainty]

imprudence=[#joyful,#admirable,incautiousness,heedlessness,incaution,rashness,mindlessness]

impulsive=[#surprising,#admirable,tearaway,madcap,incautious,hotheaded,impetuous]

impunity=[#interesting,#joyful,indemnity,exemption,unsusceptibility,diplomatic_immunity,amnesty]

impurity=[#joyful,#admirable,exhaust,garbage,dross,waste_material,material]

incautious=[#interesting,#admirable,impetuous,tearaway,impulsive,madcap,hotheaded]

incense=[#joyful,#surprising,wroth,wrathfully,wrothful,wrathful,lividity]

incite=[#joyful,#surprising,inflame,instigate,sensational,fire_up,stir_up]

incomparable=[#joyful,#surprising,nonpareil,one_and_only,peerless,unmatchable,matchless]

incomplete=[#interesting,#joyful,uncompleted,unelaborated,partial,broken,sketchy]

inconsequent=[#interesting,#admirable,trivial,lightweight,potty,unimportantial,unimportant]

inconsequential=[#interesting,#admirable,visceral,illogical,intuitive,absurd,nonrational]

inconsiderate=[#joyful,#surprising,unthinking,unthoughtful,unreflective,unconsidered,thoughtless]

inconsistency=[#interesting,#admirable,nonuniformity,heterogeneousness,heterogeneity,unsimilarity,dissimilarity]

inconstant=[#joyful,#surprising,fickle,mutable,false,untrue,volatile]

indecisive=[#joyful,#interesting,undecided,on_the_fence,hesitating,hesitant,suspensive]

indulge=[#joyful,#surprising,luxuriate,sap,expend,spend,use_up]

inelegance=[#admirable,#surprising,sleaziness,tastelessness,quality,coarseness,commonness]

inexperienced=[#joyful,#admirable,young,raw,naive,new,fledgling]

inflame=[#joyful,#interesting,stir_up,instigate,incite,sensational,fire_up]

inflated=[#surprising,#admirable,highfalutin,pretentious,portentous,snooty,hifalutin]

inhibition=[#admirable,#joyful,restraint,restriction,direct,control,command]

insolent=[#interesting,#admirable,disrespectful,undeferential,annihilating,devastating,undutiful]

instigate=[#joyful,#interesting,fire_up,stir_up,incite,sensational,inflame]

invader=[#joyful,#interesting,small_room,heavy_object,keep_out,door_handle,metal_bar]

involuntary=[#surprising,#admirable,smell_odor,bad_odor,whine,blow_nose,inhale]

irony=[#joyful,#surprising,white_rice,wheat,oat,grain,granule]

irresponsible=[#interesting,#admirable,loose,freewheeling,carefree,slaphappy,unaccountable]

issue=[#joyful,#interesting,quodlibet,gut_issue,paramount_issue,pocketbook_issue,content]

jaundiced=[#joyful,#surprising,loaded,racist,homophobic,antiblack,discriminatory]

joke=[#joyful,#surprising,tell_joke,make_commitment,paint_face,funny_joke,tell_funny_joke]

joker=[#surprising,#admirable,fool,jolly,cannibalism,demon,treachery]

jumpy=[#joyful,#admirable,overstrung,nervy,high-strung,uptight,restive]

knock=[#interesting,#admirable,dance_type,enter_contest,dance_well,water_faucet,dance_music]

lackadaisical=[#joyful,#interesting,languorous,languorously,languor,dreamy,languid]

languid=[#interesting,#admirable,languorous,languorously,lackadaisical,languor,dreamy]

languor=[#interesting,#admirable,languid,languorously,languorous,lackadaisical,dreamy]

languorous=[#joyful,#interesting,dreamy,languorously,lackadaisical,languid,languor]

languorously=[#joyful,#interesting,lackadaisical,languorous,languid,languor,dreamy]

latency=[#interesting,#admirable,potentiality,possibleness,prospect,chance,possibility]

lech=[#surprising,#admirable,satyr,letch,fetishist,degenerateer,degenerate]

lecher=[#interesting,#admirable,lech,letch,fetishist,degenerate,satyr]

letch=[#joyful,#interesting,degenerate,satyr,lecher,fetishist,lech]

liability=[#joyful,#admirable,susceptibleness,taxability,ratability,rateability,susceptibility]

limitation=[#joyful,#admirable,narrowness,restraint,rule,quantification,regulation]

limited=[#joyful,#surprising,bounded,finite,finite_state_machine,boundary,wall]

limp=[#joyful,#interesting,extension,walk_device,foot_action,stand_upon,walk_part]

loner=[#interesting,#admirable,alone,oneself,number_person,membership,significance]

longing=[#joyful,#admirable,yearning,discontent,dysphoria,disgruntlement,dissatisfaction]

loophole=[#joyful,#admirable,ambiguity,double_entendre,parisology,amphiboly,amphibology]

loot=[#joyful,#interesting,finance,mastercard,bribe,peso,profit]

loud=[#joyful,#admirable,loudness,loud_soft,loud_noise,audio,loud_sound]

lull=[#interesting,#admirable,calml,quiet,assuasive,tranquillize,soothing]

lure=[#joyful,#interesting,bait_trap,catch,ambush,decoy,trap]

mediocrity=[#interesting,#admirable,abduction,citation,exclusion,pugilist,betterment]

merciless=[#interesting,#surprising,mortal,cutthroat,bowelless,tigerish,pitiless]

mundane=[#interesting,#joyful,economic,mercenary,worldly,materialistic,material]

mysterious=[#joyful,#admirable,evaporate,foggy,wet_air,hazy,cloudy]

mystery=[#surprising,#admirable,obituary,news_story,article,riddle,editorial]

mystify=[#joyful,#interesting,stupefy,baffle,dumbfound,stupefaction,surprise]

myth=[#joyful,#surprising,classic,long_story,saga,fable,story]

noise=[#joyful,#interesting,loudness,decibel,animal_sound,loud_sound,sound]

notoriety=[#joyful,#interesting,critical,status,everyone_know,caste,seeker]

numb=[#interesting,#admirable,treatment,operation,forceps,spasm,cure]

object=[#interesting,#admirable,solid,six_sides,thing,build_block,item]

odd=[#joyful,#admirable,maximum,sum_total,backside,number,high_level]

oddity=[#joyful,#interesting,peculiarity,collector_item,curiosity,oddment,curio]

odor=[#interesting,#admirable,smell,stick_out,scent,nose,sniff]

outburst=[#joyful,#interesting,reflection,acting_out,cry,manifestation,explosion]

overbalance=[#interesting,#admirable,override,predominate,outweigh,preponderate,overarch]

overemphasize=[#interesting,#admirable,exaggerate,magnify,hyperbolize,overstate,overdraw]

overstate=[#interesting,#joyful,brag,overemphasize,embellish,overstress,vaunt]

overturn=[#interesting,#admirable,vacate,reverse,annul,lift,go_back_on]

pan=[#joyful,#surprising,scrumble_egg,food,breakfast,beat_egg,heat_meal]

partisan=[#interesting,#admirable,advocator,advocate,doctrinaire,dogmatist,bigot]

peculiar=[#joyful,#surprising,good_character,characteristic,good_quality,character_trait,description]

pedantic=[#surprising,#admirable,erudite,learned,donnish,scholarly,bookish]

peril=[#interesting,#admirable,health_hazard,risk,jeopardy,endangerment,hazard]

perplex=[#interesting,#surprising,awed,astonish,astonished,awestricken,awestruck]

perversity=[#interesting,#admirable,cussedness,willfulness,fractiousness,perseverant,unruliness]

pervert=[#interesting,#joyful,healthy_person,housekeeper,philanthropist,nazi,programmer]

plea=[#joyful,#surprising,all_right,politeness,suggest,request,demand]

plot=[#interesting,#admirable,computer_type,narrative,always_read,riddle,personality_trait]

pokey=[#surprising,#admirable,workhouse,lockup,holding_cell,bastille,hoosegow]

poky=[#interesting,#joyful,lockup,workhouse,bastille,holding_cell,hoosegow]

pretentious=[#interesting,#admirable,highfalutin,portentous,snooty,hifalutin,inflated]

prideful=[#joyful,#interesting,triumphant,exulting,rejoicing,triumphal,exultant]

procrastinate=[#joyful,#admirable,procrastination,wave_goodbye,sit_on_beach,absorb_moisture,drink_tea]

radical=[#interesting,#admirable,just_fun,fun,creepy,taboo,enjoyable]

rail=[#admirable,#surprising,token_turnstile,catwalk,platform_rail,chain,column]

rattle=[#interesting,#admirable,vibration,loud_yell,clang,tremor,squeak]

recklessness=[#surprising,#admirable,unthoughtfulness,brashness,desperation,adventurism,thoughtlessness]

rhetoric=[#admirable,#joyful,utterance,spanish,idiom,voice,whisper]

rigid=[#joyful,#admirable,inflexible,hard,hard_material,solid,durable]

ruffle=[#interesting,#admirable,jabot,goffer,gauffer,peplum,adornment]

scarce=[#interesting,#admirable,a_little,small_amount,shortage,least,little]

seriousness=[#joyful,#surprising,in_earnest,earnestness,devout,earnestly,seriously]

shake=[#interesting,#admirable,convulse,rub,wrap_around,earth_movement,wiggle]

shriek=[#surprising,#admirable,outcry,shout,yell,call,cry]

shrill=[#interesting,#surprising,call,scream,yell,cry,hollo]

shrug=[#joyful,#surprising,lunge,push,wiggle,progress,sway]

skepticism=[#interesting,#joyful,doubtfulness,doubt,dubiousness,dubiety,incertitude]

smear=[#joyful,#interesting,press_enter,scratch_back,smudge,push_button,wipe_tear]

smell=[#joyful,#admirable,aroma,smell_good,scent,smell_flower,fragrance]

smug=[#joyful,#interesting,complacence,proudly,smugness,preen,self-satisfied]

sneak=[#joyful,#surprising,thoughtfulness,consider,thief,sneak_out,brain_function]

steep=[#joyful,#interesting,slant,up_hill,knoll,mountain_side,incline]

stench=[#interesting,#admirable,odor,scent,waste_water,sniff,false_tooth]

stew=[#interesting,#joyful,soup,cream_soup,goulash,main_course,ragout]

stigma=[#admirable,#joyful,mark,symbol,religious_sign,sign,emblem]

stormy=[#admirable,#interesting,weather_type,rain_storm,natural_phenomenon,rain_wind,weather_phenomenon]

strenuous=[#interesting,#admirable,competition,winter_sport,give_dog_exercise,recreational,competitive]

strict=[#interesting,#admirable,axiom,control,kingly,obedience,govern]

strut=[#interesting,#joyful,gait,foot_movement,foot_motion,foot_action,stride]

stun=[#joyful,#surprising,dumbstricken,stupefied,stupefy,dazed,stunned]

submissive=[#interesting,#admirable,cringing,groveling,wormlike,sub,bowing]

subtract=[#joyful,#admirable,make_small,muscle_ache,win_medal,payoff,get_work_done]

succumb=[#joyful,#admirable,submit,accept,go_for,consent,give_in]

superstition=[#joyful,#surprising,prayer,preacher,preach,pulpit,judaism]

susceptible=[#admirable,#interesting,capable,amenable,vulnerable,pliable,tractable]

suspect=[#interesting,#joyful,robbery_suspect,murder_suspect,mortal,person,rape_suspect]

taboo=[#interesting,#admirable,difficult_play,just_fun,fun,creepy,competitive]

tangled=[#admirable,#interesting,knotty,rootbound,enmeshed,matted,intermeshed]

temptation=[#joyful,#interesting,woman,peach,green_apple,adam_and_eve,plum]

tenderness=[#joyful,#interesting,expectantly,lovesome,affectionate,fond,hopeful]

thoughtless=[#joyful,#interesting,unconsidered,unthinking,inconsiderate,unreflective,unthoughtful]

thwart=[#surprising,#admirable,halt,fill,continue,accept,prevent]

twist=[#joyful,#admirable,revolve,rotation,wrap_around,salsa,turn]

unaccessible=[#admirable,#surprising,trackless,untracked,pathless,outback,roadless]

unexpected=[#admirable,#joyful,birthday_party,amazement,surprise,astonishment,special_event]

unimportant=[#interesting,#admirable,potty,inconsequent,inconsequential,lightweight,trivial]

uninformed=[#joyful,#interesting,unread,unknowing,unenlightened,innocent,naive]

unnerve=[#interesting,#admirable,discomfit,disconcert,upset,untune,discompose]

unwieldy=[#interesting,#joyful,clumsy,ungainly,cumbrous,cumbersome,awkward]

uproarious=[#joyful,#admirable,screaming,hilarity,hilariously,uproariously,hilarious]

uproariously=[#joyful,#interesting,hilariously,screaming,uproarious,hilarious,hilarity]

vanity=[#joyful,#surprising,imperturbability,levity,serene,fondness,self-esteem]

vibrate=[#joyful,#interesting,back_forth,jiggle,bail_water,convulse,pull_car]

vibration=[#joyful,#interesting,ear_activity,loudness,audible,audio,loud_soft]

violator=[#joyful,#interesting,malefactor,outlaw,criminal,crook,felon]

wallow=[#joyful,#interesting,exult,exuberant,jubilant,carefreeness,jubilate]

wary=[#joyful,#admirable,watchful,guard,on_the_alert,vigilant,alert]

wasting=[#interesting,#surprising,infirmity,frailness,debility,valetudinarianism,frailty]

weaken=[#joyful,#interesting,stultify,cripple,enervate,wash_out,mollify]

weary=[#interesting,#joyful,overtire,exhaust,beat,tucker_out,tucker]

wickedness=[#joyful,#surprising,irreverence,deviltry,foul_play,devilry,sexual_immorality]

zealous=[#joyful,#surprising,eagerly,keenness,eagerness,thirstily,avidity]

