32_teeth=[#joyful,#interesting,mouth_part,gum,snot,bad_taste,near_mouth]

a_little=[#disgusting,#sad,shortage,scarce,little,small_amount,least]

a_lot_of_books=[#interesting,#admirable,magazine,librarian,cook_book,library,old_testament]

a_lot_of_space=[#surprising,#admirable,empty_room,empty_house,universe,empty,empty_space]

a_lot_of_stress=[#sad,#scared,stress,flunk,advance_next_level,failure,get_grade]

a_lot_of_study=[#sad,#scared,study_course_material,study_material,study_hard,study_a_lot,go_class]

a_lot_of_work=[#joyful,#surprising,produce_value,hard_work,prepare_event,accomplish,finish_work]

aah=[#sad,#disgusting,gee,express,utter,ooh,cry_out]

abandonment=[#sad,#scared,spare,need_break,catch_breath,need_to_rest,leg_tire]

abashment=[#sad,#scared,mortification,uncomfortableness,bashfulness,self-consciousness,self-conscious]

abatement=[#sad,#scared,remittal,break,defervescence,subsidence,remission]

abdomen=[#joyful,#interesting,fur,dog_pet,body,living_thing,two_ears]

abience=[#sad,#angry,motive,motivation,need,impulse,adience]

ability_read=[#joyful,#interesting,choose_book,information,hold_book,purchase_book,eyes]

ability_see=[#admirable,#joyful,open_eye,wear_glass,eyesight,near_tv,turn_on_tv]

abjection=[#sad,#scared,degeneration,decadence,humiliation,depth,decadency]

ablate=[#angry,#disgusting,wear_out,wear_down,wear_off,wear,wear_thin]

able_eat=[#joyful,#surprising,munch,sustenance,satisfy_appetite,replenish_energy,nourishment]

able_use=[#joyful,#interesting,promote_business,transact_business,time_consume,resolve_dispute,increase_income]

abnegate=[#angry,#disgusting,hold_in,hold,check,moderate,control]

abolish=[#joyful,#admirable,clean,clear_away,cut_out,remove,discharge]

abominable_snowman=[#joyful,#surprising,mythical_creature,mythical_monster,doppelganger,legendary_creature,yeti]

abominator=[#scared,#disgusting,anglophobe,person,hater,loather,mortal]

abortion=[#scared,#disgusting,sickness,death,medical_procedure,cure,determine_health]

abortus=[#joyful,#interesting,monster,vertebrate,baby,fetus,teras]

above=[#sad,#angry,previous,old,preceding,introductory,foregoing]

above_earth=[#admirable,#joyful,universe,without_light,massive,outer_space,limitless]

abridge=[#interesting,#admirable,ration,curtail,restrict,immobilize,limit]

abridgement=[#joyful,#admirable,resume,summary,recap,brief,report]

abrupt=[#sad,#angry,surprise,jolt,rude,sudden,jeer]

absence_seizure=[#joyful,#surprising,convulsion,ictus,raptus,focal_seizure,absence]

absent=[#sad,#scared,avoid_work,skip_class,skip_work,gone,lazy]

absolute_alcohol=[#sad,#scared,spirits_of_wine,denatured_alcohol,ethyl_alcohol,plant_product,alcohol]

absolutely=[#joyful,#interesting,balance_check_account,ask_money,earn_wage,need_money,bind_agreement]

absorb_moisture=[#interesting,#surprising,dry_clothes,shine_shoes,iron_clothes,iron_shirt,sit_on_beach]

absorb_water=[#interesting,#surprising,antiquate,hold_water,tangent,hygroscope,molecule]

abstinence=[#sad,#scared,stop,use_condom,restrain,prevent,prevent_conception]

absurdity=[#scared,#disgusting,hokum,nonsense,meaninglessness,nonsensicality,bunk]

abundance=[#joyful,#admirable,fat,a_lot,rich,plentiful,abundant]

abysmal=[#disgusting,#scared,measureless,immeasurable,unmeasured,limitless,illimitable]

academic_administrator=[#angry,#disgusting,administrator,chief,executive,head,executive_director]

academic_requirement=[#interesting,#admirable,precondition,essential_condition,sine_qua_non,prerequisite,responsibility]

academy=[#joyful,#interesting,lesson,university,school_session,undergraduate,freshman]

acceptability=[#sad,#scared,adequateness,adequacy,satisfactoriness,acceptableness,quality]

acceptableness=[#sad,#disgusting,adequacy,adequateness,acceptability,quality,satisfactoriness]

accessory=[#joyful,#interesting,stylish,adornment,protective_cover,worn,hang_hanger]

acclamation=[#joyful,#interesting,favorite,crowd,large_crowd,encore,bunch]

accomplish=[#interesting,#admirable,job,find_job,task,get_job_done,hard_work]

accomplishment=[#interesting,#admirable,sense_accomplishment,cramp,win,stardom,extreme_elation]

account_payable=[#joyful,#admirable,arrears,limited_liability,indebtedness,debt,payable]

account_term=[#joyful,#surprising,amount_owe,money_payment,money_loss,money_due,money_owe]

accountant=[#interesting,#admirable,little_child,child,football_coach,visitor,bookkeeper]

accouterment=[#scared,#disgusting,wear,furnishing,trappings,belt,wearable]

accoutrement=[#sad,#scared,belt,wearable,furnishing,trappings,wear]

accredited=[#sad,#scared,approved,licensed,authorized,commissioned,licenced]

accuse=[#scared,#disgusting,examine_evidence,become_lawyer,wear_robe,consider_evidence,accuse_person]

accuse_person=[#sad,#scared,accuse,incriminate,become_lawyer,blame,liar]

acetaminophen=[#scared,#disgusting,medicine,hydromorphone_hydrochloride,pain_pill,hydromorphone,codeine]

achievability=[#sad,#disgusting,potential,potency,conceivableness,conceivability,possibleness]

achiever=[#joyful,#admirable,natural,highflier,highflyer,mortal,great]

acid=[#scared,#disgusting,gunk,rotten_food,lemon_juice,glass_of_milk,sour_cream]

acid_indigestion=[#sad,#scared,burp,little_hungry,get_full,become_full,choke]

acidophil=[#surprising,#admirable,gonococcus,bacteriae,probiotic,probiotic_bacterium,bacteria]

acidophile=[#joyful,#interesting,probiotic,bacteria,gonococcus,probiotic_bacterium,acidophil]

acidulousness=[#sad,#scared,gustatory_sensation,acidity,sourness,taste_sensation,taste]

acne_medication=[#surprising,#admirable,hair_gel,aspirin,wax_dental_floss,hair_dryer,blow_dryer]

acolyte=[#scared,#disgusting,altar_boy,clergyman,thurifer,man_of_the_cloth,reverend]

acquire_information=[#joyful,#interesting,obtain,hear_opinion,acquire,stare,information]

acquisition=[#surprising,#admirable,heritage,restitution,assumption,moneymaking,purchase]

acquisitiveness=[#scared,#disgusting,covetousness,avarice,greed,desire,possessiveness]

act=[#interesting,#admirable,role_play,part_of_play,act_part,play_part,part_of_movie]

act_bored=[#disgusting,#sad,think_dog,master_skill,check_time,watch_other_person,finish_test]

act_foolish=[#disgusting,#angry,see_sky,become_depressed,amount_nothing,box_ear,lower_standard]

act_out=[#sad,#disgusting,listen_story,keep_word,voice_opinion,state_obvious,promise_good]

act_part=[#joyful,#admirable,part_of_play,play_part,act,portray,imitate]

act_play=[#interesting,#admirable,perform,play_guitar,play_violin,pretend,go_stage]

act_quickly=[#joyful,#admirable,run_slowly,wear_running_shoes,wear_good_shoes,use_leg,take_step]

act_smart=[#interesting,#admirable,come_to_conclusion,smart,find_answer,solve_mystery,focus_attention]

acting=[#joyful,#interesting,become_actor,star_movie,good_imagination,rehearse,role_play]

acting_out=[#joyful,#admirable,manifestation,reflection,explosion,ebullition,cry]

actinotherapy=[#joyful,#surprising,radiation,radiation_therapy,radiotherapy,irradiation,phototherapy]

action_movie=[#joyful,#interesting,genre,movie_genre,horror_movie,fictional,part_of_history]

activated=[#interesting,#joyful,oxidizable,unstable,excited,labile,reactive]

acute_gastritis=[#scared,#disgusting,chronic_gastritis,rubor,redness,gastritis,inflammation]

acute_glossitis=[#scared,#disgusting,inflammation,redness,glossodynia_exfoliativa,rubor,glossitis]

acute_triangle=[#interesting,#admirable,wedge,wedge_shape,triangle,cuneus,oblique_triangle]

adam_and_eve=[#interesting,#admirable,eden,leafy,leafy_green,apple,usual_green]

adamance=[#scared,#angry,resoluteness,firmness,firmness_of_purpose,resolution,resolve]

add_number=[#interesting,#admirable,calculation,enter_data_computer,write_computer_program,train_open_mind,add_two_numbers_together]

add_sugar=[#interesting,#surprising,drink_tea,drink_coffee,sweet,sugar,cake]

add_up_column_number=[#joyful,#admirable,compute_sum,add_up_number,program_computer,calculate_quickly,write_program]

add_up_number=[#joyful,#admirable,write_program,calculate_quickly,program_computer,compute_sum,add_up_column_number]

addictive=[#scared,#disgusting,profitable,taboo,just_s_drive,taboo,profitable]

addle=[#sad,#scared,muddle,assemble,mix_up,piece,puddle]

address_book=[#joyful,#interesting,ball_point_pen,paper_clip,glue_stick,blank_check,post-it_note]

address_envelope=[#scared,#angry,put_envelope,make_note,store_pen,make_mark_paper,write_word]

adenozine=[#admirable,#interesting,water_spill,large_body,make_up_water,water,cover_water]

adequacy=[#sad,#scared,acceptability,acceptableness,adequateness,quality,satisfactoriness]

adequateness=[#scared,#disgusting,adequacy,acceptableness,quality,acceptability,satisfactoriness]

adhesive=[#joyful,#surprising,sticky_substance,sticky,insert,flour_water,goo]

adiabatic_process=[#sad,#angry,absorption,hardening,extinction,natural_action,decay]

adience=[#angry,#disgusting,impulse,abience,need,motivation,motive]

adjoin=[#sad,#angry,neighbor,contact,touch,meet,butt_against]

adjust_seat=[#interesting,#admirable,check_mirror,turn_engine,put_key_ignition,fasten_seatbelt,change_gear]

adjust_volume=[#joyful,#surprising,earring,tap_toe,hear_song,enter_contest,tap_foot]

adjust_water_temperature=[#angry,#disgusting,water_garden,heater,shower,cook,water_lawn]

adjustable_wrench=[#joyful,#admirable,power_drill,type_of_machine,drill,air_pump,drill_bite]

adjusted=[#sad,#angry,changed,emended,paraphrastic,altered,edited]

administrator=[#scared,#disgusting,head,chief,executive_director,academic_administrator,executive]

admiration=[#admirable,#joyful,stunned,awe,stun,dazed,stupefied]

admonishment=[#interesting,#admirable,reproval,reprehension,rebuke,reproof,reprimand]

adopt_child=[#joyful,#admirable,father_child,mother_child,mommy,father_son,kinship]

adorn=[#interesting,#admirable,outerwear,stylish,coat,protective_cover,winter_clothes]

ads=[#joyful,#interesting,informative,ephemeral,advertisment,introduction,media]

adulate=[#sad,#scared,blandish,suck_up,bootlick,toady,kowtow]

adult_drink=[#sad,#disgusting,booze,strong_drink,alcoholic_drink,alcoholic_beverage,drink_alcohol]

adulteration=[#joyful,#admirable,taint,impureness,dirtiness,pollution,debasement]

adultery=[#sad,#disgusting,precaution,marry,marriage,care,affair]

advance_knowledge=[#joyful,#surprising,seek_answer,knowledge,gain_insight,understand,trivia]

advance_next_level=[#interesting,#admirable,graduate_school,a_lot_of_stress,succeed,get_grade,pass_grade]

adventure=[#interesting,#admirable,stunt,journey,activity,quest,illusion]

adventurism=[#interesting,#admirable,desperation,thoughtlessness,brashness,foolhardiness,unthoughtfulness]

adversative=[#angry,#disgusting,separative,oppositive,disjunctive,contrastive,alternative]

advert=[#sad,#scared,drag_up,bring_up,mention,cite,name]

advertise_panel=[#interesting,#admirable,restaurant_entrance,neighborhood_map,billboard,advertise_company,underground_map]

advertise_product=[#joyful,#surprising,receive_email,find_book_library,page_through_book,report_crime,check_mail]

advertisement=[#sad,#angry,toll_highway,billboard,motorway,train_track,expressway]

advertisment=[#disgusting,#angry,annoying,ads,bother,stop_watch,boring]

aeonian=[#sad,#angry,imperishable,enduring,everlasting,standing,lasting]

aerial=[#joyful,#admirable,insect,arthropods,sensory,antenna,connection]

aeroplane=[#surprising,#admirable,pilot,sky,airplane,jet,air_traffic]

aesthesis=[#scared,#disgusting,limen,masking,perception,threshold,taste]

afar=[#sad,#scared,compass_direction,long_distance_relationship,long_distance,away,distance]

affair=[#joyful,#interesting,care,adultery,precaution,marry,marriage]

affectedness=[#scared,#disgusting,unnaturalness,airs,pose,coyness,demureness]

affirm=[#interesting,#admirable,prove,shew,verify,back,demonstrate]

affirmativeness=[#joyful,#surprising,compliance,deference,disposition,agreeability,complaisance]

affliction=[#scared,#disgusting,crown_of_thorns,hardship,adversity,cross,hard_knocks]

afoot=[#interesting,#joyful,restless,ahorse,kinetic,moving,ahorseback]

afraid_death=[#sad,#angry,solitary,superlative,precision,uneducated,high_quality]

after_meal=[#joyful,#admirable,clean_teeth,brush_tooth,clean_mouth,teeth_whitening,dentist]

after_school=[#interesting,#admirable,student_place,professor,learning_place,campus,school_session]

after_shower=[#admirable,#joyful,cleaned,shower,relax_time,feel_refreshed,reinvigorated]

afterimage=[#disgusting,#angry,aftersensation,memory_picture,memory_image,mental_image,image]

aftersensation=[#angry,#disgusting,memory_picture,afterimage,mental_image,memory_image,image]

age_skin=[#scared,#disgusting,dry_wet_clothes,warm_hand,grow_plant,burn_trash,make_drunk]

age_well=[#joyful,#surprising,matured,elderly,ripped,mentality,old]

agelessness=[#angry,#disgusting,immutability,changelessness,unchangeability,unalterability,unchangeableness]

agglomerate=[#sad,#disgusting,mound,pile,heap,cumulation,funeral_pyre]

aggrandize=[#joyful,#admirable,glorify,hyperbolize,exaggerate,overstate,overdraw]

aggress=[#scared,#disgusting,move,check,harass,fork,pin]

agile=[#interesting,#admirable,find_balance,good_balance,avoid_fall,avoid_failure,skip_rope]

agility=[#surprising,#admirable,find_ball,take_step,use_leg,run_slowly,walk_quickly]

agitate=[#sad,#scared,foment,earnestness,agitated,tumult,stir_up]

agitated=[#sad,#scared,tumult,agitate,stir_up,foment,earnestness]

agitation=[#sad,#disgusting,inflame,set_off,shake_up,instigate,stir_up]

agnostic=[#joyful,#surprising,somebody,person,individual,mortal,someone]

agree_disagree=[#sad,#angry,welcome_friend,captain_boat,laugh_oneself,hang_picture_on_wall,gather_berry]

agreeability=[#joyful,#surprising,compliance,deference,affirmativeness,complaisance,disposition]

ahead=[#interesting,#surprising,late_time,preparedness,wait,past_present,straight]

ahorse=[#interesting,#joyful,afoot,restless,movingback,kinetic,moving]

ahorseback=[#joyful,#admirable,afoot,kinetic,ahorse,restless,moving]

aid=[#joyful,#admirable,look_after,emergency,assistance,sleep_disorder,care]

aim=[#joyful,#interesting,find_victim,spear,take_out,sharp_weapon,injection]

air=[#joyful,#interesting,breathable,inhale_air,hydrogen,atmosphere,oxygen]

air_bubble=[#scared,#angry,bubble,foam,froth,soap_bubble,globule]

air_movement=[#joyful,#interesting,windy,circulate_air,blow_air,move_air,blown]

air_out=[#disgusting,#scared,air,renew,vent,regenerate,freshen]

air_pressure=[#joyful,#admirable,air_density,air,pressure,heavy_air,altitude]

air_pump=[#joyful,#surprising,drill,adjustable_wrench,drill_bite,power_drill,type_of_machine]

air_ticket=[#joyful,#surprising,first_class_airplane_seat,travel,passenger_ticket,hand_luggage,plane_ticket]

air_traffic_controller=[#interesting,#surprising,most_birds,bird,pigeon,wing,vulture]

aircraft_carrier=[#joyful,#admirable,hot_air_balloon,blimp,hangar,war_museum,spaceship]

airline_seat=[#scared,#disgusting,small_seat,hide-a-bed_sofa,beanbag_chair,chair,sofa_bed]

airplane_engine=[#interesting,#admirable,engine,cannonball,knife,hatchet,angle_grinder]

airplane_seat=[#scared,#disgusting,sofa_bed,coach_seat,train_seat,first_class_train_seat,small_seat]

airport=[#admirable,#interesting,subway,depot,railway_station,airport_terminal,train_station]

airs=[#sad,#angry,pose,coyness,unnaturalness,demureness,affectedness]

airy=[#interesting,#admirable,blown,weather_element,move_air,breezy,unseen]

alarm_clock_ring=[#surprising,#admirable,hard_work,get_out_of_bed,turn_off_alarm,work_oneself,start_new_day]

alchemist=[#joyful,#interesting,honor,servant,noble,emancipation,accomplice]

alcohol=[#joyful,#admirable,drink_alcohol,cocktail,alcoholic_drink,booze,adult_drink]

alcoholic_beverage=[#sad,#disgusting,adult_drink,booze,get_drunk,ferment_beverage,alcoholic_drink]

alcoholic_drink=[#admirable,#interesting,alcoholic_beverage,drink_alcohol,beer,adult_drink,cocktail]

alcoholism=[#scared,#disgusting,become_intoxicated,use_party,lose_control,bee_sting,party]

align=[#sad,#angry,address,realine,realign,true,focus]

alikeness=[#scared,#disgusting,spitting_image,equivalence,resemblance,comparison,reflection]

all_important=[#admirable,#interesting,outstanding,master,chief,of_import,of_the_essence]

allayer=[#joyful,#admirable,someone,mortal,somebody,person,individual]

allergic_reaction=[#angry,#disgusting,mastication,pierce,put_mouth,runny_nose,chew]

alleviated=[#sad,#angry,quenched,relieved,eased,lessened,mitigated]

alleviative=[#joyful,#surprising,analgetic,analgesic,moderating,anodyne,weakening]

alley=[#admirable,#surprising,direction,alleyway,street,road,dark]

alleyway=[#interesting,#joyful,road,direction,dark,alley,street]

alligator=[#scared,#disgusting,meat_eater,predator,animal,reptile,river]

allomerism=[#scared,#angry,difference,divergence,deviation,departure,variation]

allusiveness=[#disgusting,#sad,characteristic,indirectness,mediacy,mediateness,deviousness]

almost_always=[#sad,#disgusting,book,book_poetry,book_genre,many_books,saga]

almost_there=[#surprising,#admirable,goal,destination,return_home,reach_home,near_destination]

alone=[#scared,#disgusting,feel_lonely,lonely,entire,body_type,live_in_the_mountains]

aloofness=[#sad,#disgusting,indifferent,withdrawal,apathetic,indifferently,detachment]

alpha=[#joyful,#interesting,in_charge,master,first,alpha_male,dominant_role]

alpha_male=[#disgusting,#sad,male_person,masculine,boy,male,man_child]

alphabet=[#joyful,#interesting,word,vowel,ideograph,part_of_speech,news_story]

alphabet_soup=[#sad,#angry,assortment,mixture,mixed_bag,motley,variety]

altar_boy=[#sad,#scared,acolyte,man_of_the_cloth,thurifer,reverend,clergyman]

alter_state_consciousness=[#joyful,#surprising,invigorate,loss_of_consciousness,hallucinate,think_sex,change_mind]

alteration=[#interesting,#admirable,easing,modification,disembarrassment,change,breath_of_fresh_air]

altercate=[#interesting,#surprising,debate,wrangle,spat,fall_out,brawl]

altered=[#scared,#angry,paraphrastic,edited,changed,adjusted,emended]

always_read=[#joyful,#surprising,plot,animate,personality_trait,play_role,like_read]

amass=[#scared,#disgusting,run_up,pile_up,accumulate,collect,roll_up]

amateurishness=[#joyful,#interesting,inability,ineptness,clumsiness,awkwardness,unskillfulness]

amazement=[#admirable,#surprising,perplex,marvel,astonishment,amaze,awe]

amazon=[#scared,#disgusting,parrot,bird,poll,popinjay,lovebird]

ambiversion=[#sad,#scared,extraversion,sociability,nakedness,gregariousness,openness]

ameliorating=[#interesting,#admirable,ameliorative,remedial,amelioratory,bettering,corrective]

ameliorative=[#joyful,#interesting,remedial,ameliorating,bettering,corrective,amelioratory]

amelioratory=[#joyful,#interesting,remedial,corrective,bettering,ameliorating,ameliorative]

amenable=[#interesting,#admirable,pliable,vulnerable,capable,tractable,susceptible]

amends=[#scared,#disgusting,compensation,exemplary_damages,atonement,expiation,punitive_damages]

american_flag=[#interesting,#admirable,ground,abrasive,asphalt,ground_material,rubble]

amethyst=[#joyful,#interesting,birth_stone,turquoise,gemstone,precious_stone,sapphire]

amiability=[#interesting,#surprising,temper,jolliness,humor,joviality,jolity]

amoeba=[#interesting,#admirable,microscopic,tiny_organism,heron,microbe,single_celled]

amount_owe=[#surprising,#admirable,money_due,account_term,money_payment,money_owe,money_loss]

amount_water=[#joyful,#surprising,small_amount,liquid_measurement,liquid_unit,small_size,liquid_measure]

amour_propre=[#joyful,#surprising,conceit,egotism,self-pride,self-importance,self-love]

amplify=[#scared,#disgusting,heat_up,deepen,enhance,fan,screw_up]

amuse_oneself=[#interesting,#admirable,make_gift,amuse,get_reaction,celebrate_holiday,give_pleasure]

amyloid_plaque=[#disgusting,#sad,dentist,dental_plaque,spot,arterial_plaque,plaque]

anagnost=[#interesting,#surprising,holy_order,deacon,exorcist,acolyte,doorkeeper]

analgesic=[#joyful,#interesting,pain_reliever,ibuprofen,painkiller,medicine,phenobarbital]

analgetic=[#interesting,#joyful,analgesic,moderating,anodyne,alleviative,weakening]

analphabet=[#scared,#disgusting,know_nothing,ignoramus,functional_illiterate,illiterate,illiterateic]

analyze_book=[#joyful,#surprising,review_book,read_book,write_review,revle,uncontrolled,irrepressible]

anarchism=[#sad,#angry,nazism,despot,tyrant,lack_of_rules,fascism]

anarchy=[#sad,#angry,family_activity,work_together,watch_comedy,roller_coaster,mess]

anathemize=[#sad,#disgusting,call_down,conjure,stiew,book,]

anarchic=[#sad,#angry,irrepressible,undisciplined,uncontrolled,uncontrolledal,uncontrollable,]

anarchism=[#sad,#scared,despot,fascism,nazism,lack_of_rules,tyrant,]

anarchy=[#disgusting,#sad,watch_comedy,roller_coaster,mess,work_together,family_activity,]

anathemize=[#sad,#scared,conjure,bring_up,call_down,call_forth,stir,]

anemone=[#joyful,#interesting,windflower,leaves,flower,bright_petals,plant,]

anesthetic=[#sad,#scared,insensible,asleep,emotionless,benumbed,numb,]

anglophobe=[#angry,#disgusting,person,mortal,hater,abominator,loather,]

angry_behavior=[#sad,#scared,adjust_seat,skid_mark,fasten_seatbelt,traffic_jam,road_rage,]

angry_mob=[#scared,#disgusting,protest,against,rally,picket,riot,]

angst=[#sad,#scared,nervousness,embarrassment,hysteria,consternation,humility,]

angular_shape=[#joyful,#interesting,fold,crease,plication,crimp,flexure,]

angularity=[#joyful,#surprising,crease,crimp,flexure,plication,fold,]

animal=[#joyful,#admirable,cage,reptile,mammal,wildlife,zoo,]

animal_fancier=[#disgusting,#sad,fancier,horseman,enthusiast,cat_fancier,horse_fancier,]

animal_fur=[#angry,#sad,fluffy_animal,animal_hair,animal_skin,furry,dog_fur,]

animal_furry=[#interesting,#admirable,hairy,fuzzy_animal,cute,woolly_animal,domestic_pet,]

animal_group=[#sad,#angry,strain,litter,pack,biological_group,brood,]

animal_hair=[#interesting,#surprising,animal_fur,animal_skin,furry,fluffy_animal,dog_fur,]

animal_home=[#joyful,#admirable,kennel,hive,habitat,lair,beehive,]

animal_instinct=[#joyful,#interesting,rapid_oxidation,get_burnt,instinct,create_smoke,overeat,]

animal_plant=[#joyful,#admirable,fauna,flora,grow_place,live_organism,plant_animal,]

animal_product=[#joyful,#interesting,pet,food,biodegradable,organic,toys,]

animal_shelter=[#interesting,#surprising,veterinarian_office,warm_bed,alleyway,doghouse,cage,]

animalism=[#sad,#scared,doctrine,school_of_thought,philosophy,ism,philosophical_system,]

animated_cartoon=[#interesting,#joyful,toon,short_subject,flick,newsreel,cartoon,]

animating=[#joyful,#interesting,invigorating,exhilarating,restorative,enlivening,refreshing,]

ankle=[#sad,#scared,foot,leg,hold_canvas,heel,toe,]

ankle_bracelet=[#scared,#sad,bangle,anklet,jewellery,armilla,jewelry,]

anklet=[#scared,#disgusting,jewelry,jewellery,bangle,armilla,ankle_bracelet,]

annelid=[#sad,#angry,segmented_worm,horseleech,leech_worm,leech,medicinal_leech,]

annoy_mom=[#scared,#sad,play_orchestra,play_tune,perform_of_music,play_music,make_musical_sound,]

annoy_neighbor=[#scared,#sad,play_music,make_music,create_music,produce_musical_sound,perform_of_music,]

annoy_other_person=[#sad,#disgusting,receive_email,voice_opinion,forget_name,wave_arm,reply_question,]

annoy_sound=[#sad,#scared,bang,bad_music,high_music_note,loud,squeak,]

annoying_sound=[#sad,#scared,stress,loud,bad_music,rowdy,noise,]

annul=[#angry,#disgusting,strike_down,stet,cancel,break,set_aside,]

anodyne=[#joyful,#surprising,analgetic,weakening,analgesic,alleviative,moderating,]

another_planet=[#admirable,#interesting,astrology,far_away,discover_universe,alien,mars,]

answer_back=[#interesting,#joyful,response,retort,question_answer,interrogation,write_back,]

answer_phone=[#joyful,#interesting,hunt_duck,call_friend_phone,answer_telephone,talk_telephone,call_mom,]

answer_question=[#joyful,#admirable,communicate_other_person,understand_better,commit_to_memory,transfer_knowledge,supply_answer,]

answer_telephone=[#joyful,#surprising,answer_phone,learn_listen,receive_letter,call_mom,hunt_duck,]

ant_hill=[#joyful,#interesting,grass,tress,up_mountain,fallen_leaf,hike_trail,]

antacid=[#scared,#disgusting,antiacid,ranitidine,gastric_ranitidine,histamine_blocker,alkalizer,]

antenna=[#joyful,#admirable,insect,arthropods,sensory,connection,aerial,]

anthropoid=[#scared,#angry,inhuman,bloodless,apelike,nonhumanal,nonhuman,]

antibiotic=[#interesting,#admirable,ibuprofen,pain_reliever,medicine,analgesic,painkiller,]

antiblack=[#interesting,#admirable,discriminatory,loaded,jaundiced,racist,homophobic,]

antic=[#interesting,#admirable,joke,caperper,prank,dirty_trick,]

anticipant=[#joyful,#interesting,expectant,anticipative,expectantly,fevered,hectic,]

anticipative=[#joyful,#interesting,expectantly,anticipant,expectant,hectic,fevered,]

anticipator=[#angry,#disgusting,illusionist,diviner,anticipant,intellect,intellectual,]

antidote=[#sad,#scared,atropine,remedy,therapeutic,cure,curative,]

antifeminism=[#sad,#scared,discrimination,sexual_discrimination,male_chauvinism,chauvinism,sexism,]

antihypertensive=[#sad,#angry,adrenal_cortical_steroid,spironolactone_drug,corticoid,spironolactone,corticosteroid,]

antinomy=[#sad,#scared,untruth,paradox,falsehood,contradiction_in_terms,falsity,]

antioxidant=[#scared,#sad,exercise,physical_exercise,moderation,drink_plenty_water,exercise_regularly,]

antler=[#joyful,#interesting,horn,jew_harp,brass_instrument,trumpet,crash_cymbal,]

anxiolytic=[#sad,#scared,antianxiety_drug,tranquilizer,tranquilizer_drug,minor_tranquilizer,put_to_sleep,]

apathetic=[#joyful,#interesting,unconcernedly,unconcern,unconcerned,indifferently,apathetically,]

apathetically=[#joyful,#interesting,impassivity,stolidity,impassiveness,unemotionality,emotionlessness,]

apathy=[#scared,#disgusting,stolidity,impassivity,phlegm,emotionlessness,impassiveness,]

ape=[#scared,#angry,imitator,epigon,copycat,epigonr,emulator,]

aper=[#sad,#angry,person,parrot,epigone,mortal,epigon,]

aperient=[#sad,#disgusting,physic,purgative,phenolphthalein,laxative,cathartic,]

aperitif=[#joyful,#admirable,alcohol,adult_drink,stimulate_appetite,bartender,beverage,]

apex=[#joyful,#interesting,angle,altitude,edge,semicircle,facet,]

apologize=[#sad,#scared,emotion,regret,pardon,beg,forgiveness,]

apomorphine=[#interesting,#admirable,pain_pill,painkiller,anodyne,morphia,analgesic,]

apostate=[#scared,#disgusting,untrue,unfaithful,perfidious,punic,treacherous,]

apparel=[#joyful,#interesting,nightgown,clothes,dress,shirt,garment,]

apparent_motion=[#sad,#angry,motion,optical_illusion,apparent_movement,movement,mirage,]

apparent_movement=[#sad,#scared,apparent_motion,movement,optical_illusion,motion,mirage,]

appeal=[#surprising,#admirable,witness,make_judgment,new_law,contact_lawyer,court_action,]

appear=[#interesting,#surprising,heap,arrive,come,accept,tow,]

appear_beautiful=[#joyful,#surprising,good_looking,enjoy_view,hot_girl,beauty,good_appearance,]

appear_suddenly=[#scared,#disgusting,gain_speed,go_fast,corner_well,travel_road,drive_down_street,]

appetence=[#sad,#scared,craving,addiction,desire,appetency,appetite,]

appetency=[#sad,#scared,addiction,craving,desire,appetite,appetence,]

appetent=[#surprising,#admirable,avid,envious,desirous,devouring,thirsty,]

appetite=[#joyful,#admirable,make_breakfast,prepare_meal,enjoy_meal,prepare_breakfast,put_food_into_mouth,]

applaud=[#surprising,#admirable,happiness,clap,emotional_reaction,hypnotic_effect,appreciation,]

apple_polisher=[#scared,#angry,groveler,web,fawner,crawler,bootlicker,]

apple_tree=[#interesting,#admirable,plant,red,tree,apple,fruit,]

applique=[#joyful,#interesting,mend,stitch,darn,patchwork,stitchery,]

appointment_book=[#admirable,#interesting,notepad,pocket_notebook,highlighter_pen,address_label,memo_pad,]

appraise=[#interesting,#admirable,handle_carefully,deflate,upgrade,read_cover,look_behind,]

appreciate=[#interesting,#surprising,good_feeling,happiness,enjoy_oneself,desire_entertain,self_satisfaction,]

appreciation=[#joyful,#interesting,new_idea,inspiration,increase_intelligence,improve_performance,insight,]

apprehend=[#admirable,#joyful,understand,intuit,tumble,digest,twig,]

apprehensive=[#sad,#angry,anxiouslyly,worried,anxiously,uneasily,solicitousness,]

apprentice=[#joyful,#interesting,much_information,serious_student,pupil,hard_worker,student,]

approximate=[#sad,#scared,inexact,approximative,rough,odd,loose,]

approximative=[#scared,#disgusting,approximate,loose,rough,inexact,odd,]

aqua=[#interesting,#admirable,cyan,violet,indigo,bird_pet,favorite_color,]

aquarium=[#joyful,#surprising,ocean_wave,underwater,sea,pacific_ocean,ocean,]

arachnid=[#disgusting,#angry,arthropod,social_insect,fly_insect,vermin,insect,]

archeological_remains=[#sad,#scared,physical_object,remains,collectible,fossil,object,]

archeology=[#sad,#angry,keep_fresh,appetizer,food,porridge,piece_of_meat,]

architect=[#interesting,#admirable,profession,vocation,finish_school,engineer,reporter,]

architect_office=[#joyful,#interesting,bluegrass_band,math_book,band_room,math_class,science_lab,]

architectural_style=[#surprising,#admirable,perpendicular,gothic_architecture,perpendicular_style,type_of_architecture,style_of_architecture,]

arctic=[#disgusting,#angry,cold,cold_weather,snow,without_human_habitation,ice,]

ardor=[#joyful,#interesting,avidity,avidness,passion,eagerness,thirstily,]

#interesting,#surprising,accuse,asperse,malign,libel,charge]

assertion=[#surprising,#admirable,charge,testimony,contention,claim,accusation]

assess=[#admirable,#joyful,film_critic,wish_entertain,enjoyment,evaluate,entertainment]

asseverate=[#joyful,#surprising,take_a_firm_stand,say,predicate,aver,insist]

asseveration=[#interesting,#admirable,contention,claim,testimony,charge,accusation]

asshole=[#scared,#angry,womb,sister_house,anus,land_moon,gone_moon]

assignment=[#joyful,#interesting,text_book,textbook,school_work,learn_tool,homework]

associate=[#interesting,#surprising,tap_foot,enter_contest,dance_well,tap_toe,adjust_volume]

assume=[#joyful,#surprising,presume,posit,postulate,presuppose,take_for_granted]

assurance=[#joyful,#interesting,frivolity,total,excellence,importance,quality]

asternal=[#scared,#disgusting,separate,separated,unattached,unconnected,isolated]

asthenia=[#angry,#disgusting,frailty,valetudinarianism,infirmity,debility,frailness]

astheny=[#scared,#sad,frailness,debility,valetudinarianism,frailty,infirmity]

asthma=[#sad,#scared,tidiness,house_look_better,spider,barf,back_pain]

asthmatic=[#scared,#disgusting,someone,person,individual,mortal,somebody]

astonishment=[#interesting,#admirable,marvel,amaze,wonder,amazement,awe]

astounding=[#joyful,#admirable,staggering,bewilder,flabbergasted,stupefying,astonishing]

astringence=[#sad,#scared,taste_sensation,taste,gustatory_perception,gustatory_sensation,taste_perception]

astringency=[#scared,#disgusting,taste_sensation,gustatory_sensation,taste,gustatory_perception,taste_perception]

astrology=[#interesting,#admirable,message_board,artificial,post_notice,mail_delivery,creationism]

atheist=[#sad,#disgusting,classroom_chair,exam_table,text_book,lead_pencil,eraser_holder]

athletic_game=[#interesting,#admirable,sport,ice_hockey,game,hockey_game,hockey]

athletic_training=[#interesting,#admirable,activity,drill,grooming,discipline,practice]

athleticism=[#sad,#disgusting,force,strength,vigor,forcefulness,strenuosity]

atlantic_ocean=[#joyful,#admirable,mere,pond,pacific_ocean,lake,small_lake]

atmosphere=[#joyful,#interesting,oxygen,air,inhale_air,hydrogen,breathable]

atmospheric_phenomenon=[#sad,#angry,natural_disaster,weather_element,tropical_storm,flood,hurricane]

atom=[#interesting,#admirable,rash,human_body,nucleus,fuse,cell]

atomic_number_1=[#scared,#angry,transactinide,chemical_element,nonmetal,xenon,hydrogen]

atrium=[#scared,#disgusting,many_homes,fancy_house,abide,outside_house,front_house]

atropine=[#sad,#angry,therapeutic,remedy,antidote,cure,curative]

attack_enemy=[#sad,#disgusting,cause_death,ready_troop,casualty,war,invade]

attacker=[#scared,#disgusting,soldier,army,infantry,samurai,military]

attain=[#sad,#scared,make,hit,gain,reach,bottom_out]

attempt_bribe=[#disgusting,#angry,hurt_else,commit_perjury,steal,commit_murder,get_away_crime]

attend_concert=[#joyful,#interesting,cheering,popcorn,watch_play,applause,entertainment]

attend_opus=[#scared,#angry,go_concert,go_opus,go_movie,turn_stereo,watch_musician_perform]

attendant=[#angry,#disgusting,personnel,gentleman,manager,elect_official,slave]

attic=[#scared,#disgusting,hamper,shoe_store,closet,obstruct,shoe_shop]

attract=[#admirable,#interesting,catch,tug,get,arrest,retract]

au_pair=[#sad,#disgusting,exile,gringo,foreigner,deportee,import]

auction=[#joyful,#interesting,another_planet,some_place,babysitter,baby_sitter,death_row]

audibility=[#interesting,#joyful,audibleness,perceptibility,visibleness,visibility,physical_property]

audibleness=[#interesting,#admirable,physical_property,visibleness,audibility,visibility,perceptibility]

audience=[#joyful,#surprising,committee,crowd,large_crowd,public,entertain_crowd]

auditor=[#sad,#scared,observer,beholder,eavesdropper,percipient,perceiver]

aureole=[#joyful,#surprising,visible_radiation,visible_light,light,corona,radiance]

auspicate=[#admirable,#interesting,bespeak,threaten,betoken,signal,foreshow]

auspice=[#interesting,#surprising,presage,omen,prognostic,prognostication,portent]

authorized=[#angry,#disgusting,approved,licensed,licenced,commissioned,accredited]

auto=[#sad,#disgusting,motorcar,car,gas_guzzlermobile,gas_guzzler,machine]

autobahn=[#admirable,#interesting,state_highway,expressway,throughway,freeway,motorway]

autocrat=[#sad,#angry,dominance,dictator,tyrant,despot,despotism]

autumn=[#scared,#disgusting,avalanche,snow_fall,volcano,skier,winter]

autumn_leaf=[#scared,#disgusting,tropical_fish,pink_flower,disney,wood_duck,beau]

autumn_sneezeweed=[#scared,#disgusting,owlclaws,orange_sneezeweed,rosilla,sneezeweed,herb]

avalanche=[#sad,#scared,autumn,snow_fall,winter,skier,volcano]

avarice=[#sad,#scared,desire,greed,acquisitiveness,possessiveness,covetousness]

avaricious=[#angry,#disgusting,grasp,covet,grabby,prehensile,covetousness]

avenue=[#disgusting,#scared,curb,boulevard,lane,intersection,thoroughfare]

aver=[#joyful,#surprising,insist,take_a_firm_stand,predicate,say,asseverate]

average_out=[#sad,#disgusting,cipher,work_out,calculate,reckon,cypher]

averment=[#joyful,#surprising,charge,claim,contention,accusation,testimony]

averting=[#interesting,#joyful,near_thing,aversion,avoidance,rejection,escape]

avian=[#joyful,#admirable,wing_creature,aviation,wing_animal,flap_wing,wing_insect]

aviation=[#interesting,#admirable,wing_creature,avian,wing_animal,wing_insect,flap_wing]

avidity=[#sad,#scared,thirstily,eagerness,avid,avidness,eagerly]

avidness=[#scared,#disgusting,keenness,thirstily,eagerness,avidity,eagerly]

avoid=[#sad,#scared,prevent,refrain_from,avoid_conversation,avoid_fight,avoid_person]

avoid_conflict=[#interesting,#joyful,learn_patience,seek_clarification,conformist_attitude,discuss,understand_each_other]

avoid_conversation=[#sad,#scared,avoid,escape,refrain_from,prevent,avoid_person]

avoid_detention=[#interesting,#admirable,think,good_citizen,behave,make_up_story,follow_rule]



cheat=[#disgusting,#sad,shuffle_card,failure,a_lot_of_stress,further_goal,flunk]

cheat_spouse=[#scared,#disgusting,ridicule,infidelity,need_help,vengeance,caution]

cheater=[#sad,#scared,deceiver,slicker,beguiler,cheat,dodger]

cheating=[#admirable,#joyful,deceit,gerrymander,deception,dissimulation,dissembling]

check_breathe=[#sad,#scared,desire_help,stop_bleed,check_oneself_mirror,look_out_window,fee_animal]

check_doctor=[#scared,#angry,lift_weight,eat_balance_diet,join_gym,go_gym,workout]

check_email=[#interesting,#admirable,phone_line_busy,use_search_engine,check_mail,look_for_information,search_information]

check_health=[#angry,#disgusting,eat_well,diagnose_illness,stay_healthy,maintain_good_health,do_exercise]

check_listing=[#sad,#scared,pay_ticket,go_cinema,go_movie_theater,buy_popcorn,go_to_the_theater]

check_mirror=[#sad,#disgusting,fasten_seatbelt,adjust_seat,put_key_ignition,mirror,turn_engine]

check_out=[#angry,#disgusting,hotel,holiday,go_home,travel,staycation]

check_price=[#scared,#disgusting,buy_goods,buy_item,make_purchase,acquire_goods,buy_stuff]

check_time=[#sad,#scared,get_bored,act_bored,finish_test,watch_other_person,think_dog]

check_tire=[#sad,#angry,know_how_drive,put_key_ignition,find_car_key,drive_license,start_car_engine]

check_traffic=[#sad,#angry,relieve_boredom,check,date_activity,find_out_weather,learn_news]

check_up_car=[#admirable,#interesting,repair_motorcycle,repair_car,car_workshop,repair_shop,workshop]

check_wallet=[#sad,#angry,take_out_wallet,compare_price,pay_food,look_price,decide_buy]

check_weather=[#scared,#disgusting,go_outside,put_running_shoes,go_park,put_shoes,put_jogging_shoes]

checkbook=[#interesting,#admirable,spare_change,checkbook_cover,billfold,savings,banknote]

checkbook_cover=[#sad,#angry,cover,passport_case,lip_balm,checkbook_holder,account_book]

checkbook_holder=[#scared,#sad,checkbook_cover,credit_card_wallet,coin_purse,pouch,clutch_bag]

checkup=[#interesting,#admirable,medical_examination,medical_exam,scrutiny,scan,medical_scrutiny]

cheek=[#sad,#angry,mouth,nose,dimple,mucus,jaw]

cheer_up=[#admirable,#interesting,glee,have_fun,crowd_cheer,great_time,joke_around]

chemical_change=[#joyful,#surprising,chemical_process,zymosis,top_fermentation,bottom_fermentation,vinification]

chemical_element=[#angry,#disgusting,nonmetal,atomic_number_1,xenon,hydrogen,transactinide]

chemical_irritant=[#angry,#disgusting,capsaicin,gingerol,piperine,pepper_spray,substance]

chemiluminescence=[#angry,#disgusting,luminescence,light,visible_light,visible_radiation,bioluminescence]

chess_tournament=[#sad,#disgusting,computer_lab,mortuary,grandma_house,game_room,old_folk_home]

chesterfield=[#interesting,#surprising,stool,tape_machine_room,tripod_dolly,bicyle,chair]

chestnut=[#angry,#disgusting,coffee,brownness,chocolate,buff,deep_brown]

chesty=[#disgusting,#angry,sturdy,robust,hardy,husky,stalwart]

chew=[#scared,#angry,put_mouth,pierce,mastication,runny_nose,allergic_reaction]

chew_bone=[#interesting,#admirable,ride_car,play_fetch,play_human,run,dog]

chew_food=[#interesting,#surprising,put_food_mouth,eat_much,eat_dinner,eat_beef,eat_food]

chew_gum=[#disgusting,#scared,read_paper,use_logic,order_food,tell_secret,find_book_library]

chew_pencil=[#sad,#scared,get_nervous,write_essay,look_clock,scratch_head,write_down]

chew_the_fat=[#interesting,#admirable,jawbone,schmoose,schmooze,shmooze,shmoose]

chew_tobacco=[#sad,#angry,shit,ooze,make_anger,fall_down_flight_stair,lean_over]

chicken=[#joyful,#surprising,chicken_soup,chick,quail,chicken_egg,male_chicken]

chicken_breast=[#sad,#scared,affliction,pigeon_breast,deformity,clubfoot,talipes]

chicken_egg=[#scared,#disgusting,wren,quail,sparrow,stork,chicken]

chicken_scratch=[#sad,#angry,squiggle,hand,handwriting,cacography,script]

chickweed=[#scared,#disgusting,common_chickweed,herb,greater_stitchwort,starwort,stitchwort]

chief=[#angry,#disgusting,head,academic_administrator,executive_director,executive,administrator]

chill_out=[#joyful,#surprising,drink,rest_area,relax_time,party,friend_gathering]

chilliness=[#sad,#angry,cold,low_temperature,frigidness,coldness,frigidity]

chimpanzee=[#joyful,#admirable,panda,cute_animal,creature,many_animals,donkey]

chinatown=[#sad,#scared,pirate_ship,radio_station,military_base,old_movie,movie]

chip=[#sad,#disgusting,stool,cow_dung,cow_droppings,droppings,dejection]

chipmunk=[#joyful,#surprising,big_rat,hare,bear,grizzly,omnivore]

chisel=[#sad,#scared,drill_bite,power_drill,air_pump,adjustable_wrench,screwdriver]

chiseler=[#sad,#scared,gouger,defrauder,fraud,welcher,swindler]

chitchat=[#sad,#angry,chat,chit_chat,gossip,gab,small_talk]

chlorine=[#scared,#disgusting,shallow_water,swimmer,lifeguard,still_water,large_body]

chocolate_bar=[#joyful,#surprising,leftover,pumpkin_pie,carton_milk,candy,unhealthy_food]

choir_stall=[#joyful,#interesting,rastafarian,fundamentalist,pulpit,pew,altar]

chondroma=[#disgusting,#sad,benign_tumor,enbenign_tumor,adenoma,fibroma,myoma]

choose_book=[#sad,#disgusting,book_library,good_book,ability_read,hold_book,find_book]

choose_color=[#joyful,#interesting,ship_goods,charge_credit_card,squeeze,group_object,sit_toilet]

choose_destination=[#disgusting,#angry,decide_want_go,decide_to_go_first,decide_to_go,talk_to_travel_agent,good_shoes]

choose_eat=[#scared,#disgusting,piece_of_meat,fix_breakfast,prepare_breakfast,decide_eat,sell_vegetable]

choose_subject=[#sad,#disgusting,review_material,knowledge_subject,go_college,study_material,revise]

chop_down_tree=[#disgusting,#angry,jump_out_of_window,ski,prune_tree,skate,climb_mountain]

chop_tree=[#sad,#scared,cut_lumber,cut_tree,cut_wood,cellulose,timber]

chop_vegetable=[#sad,#scared,cut_food,brown_hamburger,open_package,stir_pot,prepare_breakfast]

choral=[#joyful,#surprising,high_school_band,drum_set,string_quartet,school_band,band]

chorus=[#joyful,#interesting,band,school_choral,drum_set,string_quartet,choral]

chowder=[#sad,#angry,fillet,underwater,port,fillet_fish,ocean_water]

christian_fundamentalist=[#scared,#disgusting,fundamentalist,pope,christian,crusade,religion]

chromatography=[#joyful,#surprising,natural_action,paper_chromatography,column_chromatography,activity,natural_process]

chronic_gastritis=[#angry,#disgusting,inflammation,gastritis,rubor,acute_gastritis,redness]

chuckle=[#joyful,#surprising,giggle,laughter,make_others_laugh,hear_joke,make_fun]

chute=[#scared,#disgusting,gutter,sloping_trough,slideway,cullis,slide]

chutzpanik=[#sad,#scared,someone,somebody,person,mortal,individual]

cigar=[#sad,#scared,pollution,tobacco,bad_air,smoke,bad_airette]

cigarette_lighter=[#interesting,#surprising,magnify_glass,rub_two_stick_together,light_match,light_cigarette,strike_match]

cincture=[#scared,#disgusting,girdle,cummerbund,waistband,waistcloth,sash]

cinderella=[#sad,#scared,rule,go_home_early,limitation,curfew,restriction]

cinema=[#joyful,#admirable,movie,drive-in_movie,theater,movie_theater,movie_house]

cinema_verite=[#sad,#angry,moving_picture,flick,movie,film,picture]

cipher=[#sad,#disgusting,cypher,reckon,calculate,work_out,average_out]

circulate_blood=[#admirable,#interesting,circulation,massage,exercise,sex,blood]

circulating_blood=[#joyful,#surprising,blood_pressure,keep_alive,body_working,heart,body_system]

circulation=[#admirable,#surprising,massage,sex,blood,circulate_blood,exercise]

circumspection=[#scared,#disgusting,judgment,confidentiality,sagacity,discernment,sagaciousness]

circumstances=[#joyful,#surprising,good_luck,tough_luck,good_fortune,luckiness,failure]

circus_performer=[#joyful,#interesting,bold,emote,form_of_social_interaction,stage_play,act]

citation=[#joyful,#admirable,permit,effect,demand,suspicion,cite]

cite=[#interesting,#admirable,demand,suspicion,citation,effect,permit]

citizens_committee=[#scared,#sad,mission,missionary_post,ngo,denomination,committee]

citizien=[#interesting,#admirable,resident,stair_rail,ceiling_fan,tenant,roommate]

city_block=[#surprising,#admirable,junk_yard,corner_two_streets,city_road,street_corner,city_street]

city_road=[#interesting,#admirable,city_street,corner_two_streets,junk_yard,street_corner,city_block]

city_street=[#sad,#disgusting,street_corner,city_block,junk_yard,city_road,corner_two_streets]

civic_center=[#interesting,#admirable,city_street,city_block,city_park,city_center,house]

cladding=[#interesting,#joyful,protective_covering,revetment,protection,protective_cover,cover]

clade=[#scared,#sad,group,biological_group,taxonomic_group,genotype,animal_group]

claim=[#joyful,#surprising,have,heap,possess,belong,ask]

clamor=[#sad,#angry,noise,loud_noise,clang,roar,squeak]

clamp_binder=[#sad,#angry,pencil_sharpener,ball_point_pen,stapler,white-out,fastener_binder]

clang=[#admirable,#surprising,squeak,clamor,sound,noise,roar]

clannishness=[#disgusting,#sad,arrogance,cliquishness,haughtiness,exclusiveness,snobbery]

clap=[#interesting,#joyful,emotional_reaction,giggle,tear_eye,applaud,hurt_ear]

claptrap=[#sad,#scared,flourish,ornateness,rant,bombast,fustian]

clarification=[#sad,#scared,teach_others,seek_understanding,understand,tell_other_person,trivia]

clash=[#sad,#scared,quarrel,fight,combat,struggle,debate]

clasp=[#surprising,#joyful,badge,clamp,pin,drill_bite,without_space]

class=[#sad,#disgusting,take_music_lesson,learn_read_music,take_lesson,look_up_word_in_dictionary,find_teacher]

class_action=[#joyful,#surprising,petition,political_statement,posture,go_against,require]

classes=[#interesting,#surprising,study,teach_school,education,teach_to_read,find_school]

classroom_chair=[#scared,#disgusting,pencil_sharpener,text_book,exam_table,eraser_holder,lead_pencil]

claver=[#joyful,#admirable,jawbone,shmooze,schmoose,shmoose,schmooze]

clavichord=[#interesting,#admirable,triangle,type_of_bow,bugle,horn,baton]

claymore=[#admirable,#interesting,steel,brand,broadsword,sword,blade]

clean_apartment=[#joyful,#interesting,clean_sink,kill_spider,tidy_up,clean_floor,call_up]

clean_bathroom=[#sad,#scared,clean_room,clean_house,clean,wipe_up_spill,clean_carpet]

clean_body=[#admirable,#joyful,feel_refreshed,shower,remove_dirt_body,personal_hygiene,clean_oneself]

clean_car=[#admirable,#surprising,clean_hair,run_out_soap,cleanliness,remove_dirt,clean_skin]

clean_carpet=[#joyful,#interesting,clean_bathroom,clean_floor,keep_house_clean,vacuum,expect_guest]

clean_cloth=[#joyful,#interesting,use_clean,sweeper,clean_supply,clean_hand,cleanse]

clean_fish=[#disgusting,#scared,piss,make_coffee,relieve_oneself,make_ice,fry_fish]

clean_hair=[#interesting,#joyful,run_out_soap,remove_dirt,cleanliness,clean_skin,clean_kitchen]

clean_house=[#admirable,#interesting,clean_room,wipe_up_spill,clean_carpet,clean,clean_bathroom]

clean_lady=[#sad,#scared,cleaning,staff,lady,maid,servant]

clean_laundry=[#joyful,#interesting,washing_machine,clean_clothes,laundry,remove_dirt,cleanse]

clean_room=[#sad,#disgusting,wipe_up_spill,clean_carpet,clean,clean_bathroom,clean_house]

clean_shoes=[#interesting,#joyful,make_pretty,paint_nail,remove_paint,find_home,sanitary]

clean_sink=[#disgusting,#sad,pet_cat,mow_grass,sit_on_beach,absorb_moisture,wash_window]

clean_skin=[#joyful,#interesting,cleanliness,remove_dirt,wash_away_dirt,cleanse_body,run_out_soap]

clean_supply=[#joyful,#interesting,cleanse,soap,use_clean,clean_hand,clean_cloth]

clean_teeth=[#admirable,#joyful,after_meal,dentist,brush_tooth,teeth_whitening,clean_mouth]

clean_toilet=[#sad,#scared,clean_sink,sit_on_beach,dust_furniture,wash_window,clean_floor]

clean_tooth=[#surprising,#admirable,brush_tooth,clean_mouth,after_meal,teeth_whitening,dentist]

clean_underwear=[#joyful,#interesting,prescription_medication,panties,lingerie,pantyhose,slack]

clean_up=[#joyful,#interesting,remove_stain,feel_dirty,clean_up_kitchen,stink,stink_mess]

clean_water=[#admirable,#interesting,dampness,water_container,water,cool_water,still_water]

clean_window=[#scared,#disgusting,cleanser,clean_agent,remove_dirt,feel_dirty,remove_stain]

cleaned=[#interesting,#surprising,after_shower,reinvigorated,feel_refreshed,relax_time,shower]

cleaning=[#sad,#angry,servant,staff,clean_lady,maid,lady]

cleanliness=[#admirable,#joyful,get_rid_of_dirt,cleanness,personal_cleanliness,run_out_soap,wash_away_dirt]

cleanness=[#joyful,#interesting,clean,cleanliness,wash_away_dirt,personal_cleanliness,run_out_soap]

cleanse=[#scared,#angry,decontaminate,wash,bathe,floss,lather]

clear_away=[#joyful,#interesting,remove,clean,abolish,discharge,cut_out]

clear_sailing=[#joyful,#surprising,procession,forward_motion,progression,progress,onward_motion]

clear_table=[#interesting,#surprising,find_table,keep_eye_open,order_menu,place_order,bend_over]

clear_the_air=[#sad,#disgusting,drive_away,drive_out,drive_off,dispel,chase_away]

clear_throat=[#disgusting,#angry,mouth_move,use_voice,hear_voice,whisper,move_tongue]

clenched=[#scared,#angry,narrow_road,narrow,cramped,poky,tight]

cleome=[#sad,#angry,stinking_clover,herb,spider_plant,herbaceous_plant,spider_flower]

cliche=[#angry,#disgusting,teeth,dimple,mouth,tooth,jaw]

cliched=[#scared,#angry,unoriginal,dusty,banal,cold,slavish]

click_link=[#joyful,#interesting,find_porn,write_email,learn_program,learn_program_language,learn_computer_language]

cliff-hanging=[#sad,#scared,suspenseful,apathetically,unconcern,nail-biting,suspensive]

climate=[#joyful,#interesting,spring,sunny,weather,snow,four_seasons]

climb=[#joyful,#interesting,store_garage,reflect_water,mountain_climb_mountain,climb_mountain,chop_down_tree]

climb_hill=[#scared,#disgusting,expend_energy,little_pollution,view_nature,enjoy_nature,strain_muscle]

climb_ladder=[#scared,#sad,frame_picture,staircase,paint_ceiling,take_photograph,picture_scene]

climb_mountain=[#surprising,#admirable,mountain_climb,store_garage,chop_down_tree,climb,reflect_water]

climb_rock=[#sad,#scared,feel_faint,eat_healthy_diet,play_saxophone,dance_well,exercise_much]

clinic=[#scared,#disgusting,nurse_home,doctor_office,hospital,medical_office,emergency_room]

clink=[#scared,#angry,pokey,jailhouse,jail,holding_cell,slammer]

clip=[#interesting,#admirable,paperclip,clamp,clothespin,clasp,glue_stick]

clipboard=[#sad,#scared,intern,eraser_holder,electric_pencil_sharpener,stick_eraser,pencil_sharpener]

clipper=[#scared,#angry,razor,haircut_scissor,scissor,double_edge_razor,pair_of_scissors]

cliquishness=[#scared,#disgusting,haughtiness,exclusiveness,arrogance,snobbery,clannishness]

cloak=[#scared,#sad,shirt,outerwear,jacket,winter_clothes,coat]

clock=[#sad,#scared,find_pawnshop,wristwatch,stopwatch,timepiece,watch]

clock_face=[#joyful,#interesting,device_measure_time,timekeeper,tell_time,time,swiss_watch]

clock_out=[#scared,#disgusting,sit_back_relax,stop_work,make_sex,quit_work,put_clothes_back]

clog=[#interesting,#admirable,hairball,waste_water,still_water,false_tooth,go_lake]

clog_artery=[#angry,#disgusting,world_hunger,salivate,full_stomach,eat,satisfy_crave]

clogged=[#scared,#disgusting,block,shutter,close,obstruct,occluded]

close_book=[#sad,#scared,jot_down_note,sleep_back,study_library,drink_cup_coffee,study_book]

close_case=[#sad,#scared,convict_criminal,question_witness,seek_justice,find_guilty,call_police]

close_curtain=[#joyful,#surprising,look_out_window,page_through_book,pull_up_cover,oversleep,check_email]

close_deal=[#sad,#scared,arrive_work,finish_task,reply_question,forget_name,buy_stock]

close_door=[#sad,#scared,find_location,drop_ball,blow_horn,open_door,try_best]

close_eye=[#scared,#disgusting,lie_down,wear_pyjamas,sleepwalk,lay_down,wind_down]

close_mouth=[#scared,#disgusting,inhale,cough,eat_peanut,call_911,shut_up]

close_up=[#sad,#disgusting,obturate,obstruct,block,jam,block_off]

close_window=[#sad,#angry,open_car_door,put_key_ignition,start_car_engine,stay_sober,find_car_key]

closed_minded=[#sad,#scared,strict,go_by_the_book,follow_rule_blindly,dumb,inflexible]

closer=[#scared,#sad,relief_pitcher,twirler,hurler,pitcher,finisher]

closet=[#scared,#disgusting,under_bed,sock_drawer,under_back_sofa,back_sofa,under_carpet]

closing_time=[#admirable,#interesting,rest_dream,shut_eye,inactivity,sleep_time,rest_night]

clotbur=[#joyful,#admirable,lesser_burdock,common_burdock,subshrub,suffrutex,great_burdock]

cloth=[#sad,#angry,make_make_clothes,make_shirt,apparel,make_cloth,article_make_clothes]

clothe=[#sad,#angry,enoverclothe,raiment,dress,garb,overclothe]

clothes=[#joyful,#surprising,shirt,robe,dress,piece_of_clothing,fashion]

clothes_accessory=[#joyful,#interesting,waterproof,animal_hide,pantyhose,panties,animal_pelt]

clothes_clean=[#joyful,#interesting,clean_skin,become_cleaner,remove_dirt,feel_clean,run_out_soap]

clothes_dirty=[#joyful,#interesting,clothes_clean,sort_clothes,remove_dirt,smell_better,use_water]

clothes_drawer=[#joyful,#surprising,department_store,woman_closet,many_stores,clothes_store,store]

clothes_factory=[#scared,#disgusting,factory,store_cloth,sheath,clothes,pollution]

clothes_hanger=[#admirable,#interesting,hang_up_clothes,hang_clothes,hanger,laundry,storage_space]

clothes_material=[#interesting,#admirable,silk,plant_material,fabric_type,natural_fabric,natural_fiber]

clothes_shelf=[#joyful,#interesting,jeans,cupboard,compartment,drawers,hangers]

clothes_shrink=[#interesting,#admirable,become_wet,smell_better,become_cleaner,dry_skin,clothes_clean]

clothes_storage=[#scared,#disgusting,hang_clothes,hang_up_clothes,clothes,store_clothes,storage_space]

clothes_store=[#scared,#disgusting,many_stores,department_store,store,clothes_drawer,woman_closet]

clothes_store_change_room=[#joyful,#interesting,garment_bag,fit_room,clothes_shelf,changing_room,dress_room]

clothespin=[#admirable,#surprising,clasp,paperclip,clip,clamp,glue_stick]

clothing=[#joyful,#interesting,glove,wear,hand_wear,muff,wearable]

cloudiness=[#sad,#angry,inclemency,weather,overcast,storminess,raw_weather]

cloudy=[#interesting,#admirable,carry_water,dew,up_high,weather_condition,hazy]

clout=[#scared,#disgusting,knockout_punch,poke,lick,biff,punch]

clowning=[#joyful,#admirable,lunacy,folly,shtik,indulgence,craziness]

club_chair=[#interesting,#admirable,rock_chair,sofa_bed,armchair,sofa_hide_bed,chair]

clubfoot=[#sad,#angry,deformity,pigeon_breast,affliction,chicken_breast,talipes]

clue=[#interesting,#admirable,verbosity,hint,opponent,find_play,option]

clumsiness=[#interesting,#admirable,amateurishness,unskillfulness,ineptness,awkwardness,inability]

cluster=[#interesting,#joyful,group,big_group,clique,bunch,several_people]

clutch_bag=[#interesting,#joyful,bag,pouch,coin_purse,checkbook_holder,credit_card_wallet]

clutter=[#joyful,#admirable,white-out,stapler,postal_counter,coworker,paperwork]

coach=[#joyful,#interesting,trainer,instructor,train,personal_trainer,fit_person]

coach_seat=[#admirable,#surprising,seat,stool,chair,couch,bench]

coal=[#angry,#disgusting,gas,inert_gas,fuel,diesel,kerosene]

coal_mine=[#surprising,#joyful,soil,footprint,dirt,mine,compost]

coarseness=[#surprising,#admirable,sleaziness,tastelessness,inelegance,commonness,quality]

coaster=[#sad,#angry,post-it_note,glue_stick,post_note,computer_monitor,address_book]

coat=[#joyful,#surprising,winter_clothes,adorn,outerwear,stylish,protective_cover]

coat_hanger=[#disgusting,#sad,hanger,bikini,slipper,storage_item,gay_person]

coat_of_mail=[#interesting,#admirable,body_armor,bulletproof_vest,vest,suit_of_armor,waistcoat]

coat_wall=[#joyful,#interesting,dry,palette,artist_tool,paint,coat_surface]

cobalt=[#scared,#disgusting,pigment,many_shades,cyan,green_yellow,material]

cobaltite=[#joyful,#surprising,mineral,cerussite,quartz,white_lead_ore,molybdenite]

cobol=[#joyful,#admirable,helpful_tool,type_of_fruit,helpful,woodworking_tool,hand_tool]

cobra=[#interesting,#admirable,rattlesnake,animal,python,snake,reptile]

cobweb=[#sad,#scared,dust,wine_bottle,undead,read,storage_box]

cockamamie=[#interesting,#admirable,unbelievable,farfetched,unlikely,implausible,cockamamy]

cockamamy=[#joyful,#admirable,unlikely,unbelievable,farfetched,cockamamie,implausible]

cockroach=[#sad,#scared,hare,annoy_bug,insect,bug,nymph]

cocktail=[#joyful,#admirable,bourbon,booze,beverage,vodka,alcoholic_beverage]

cocktail_cabinet=[#surprising,#admirable,bar_stool,rest_room,coffee_table,stool,chair]

cocktail_party=[#joyful,#interesting,get_sex,network,interest_person,social_occasion,become_intoxicated]

coddler=[#joyful,#interesting,mortal,person,somebody,someone,individual]

codeine=[#sad,#scared,phenobarbital,morphine,palliative,analgesic,drug]

coeducation=[#joyful,#admirable,didactics,continuing_education,course,activity,extracurricular_activity]

coercion=[#scared,#disgusting,force,volt,power_source,moon_gravity,watt]

coffee=[#joyful,#surprising,hot,bubble,tea,boil_water,steam]

coffee_break=[#joyful,#surprising,middle_day,take_break,work_break,inactivity,recover]

coffee_cup=[#interesting,#surprising,drink_tea,coffee,caffeine,drink_coffee,coffee_shop]

coffee_house=[#surprising,#admirable,internet_cafe,coffee,drink_coffee,backpack,meet_up]

coffee_mug=[#admirable,#interesting,drink_tea,drink_coffee,coffee_shop,coffee,caffeine]

coffee_roll=[#sad,#disgusting,cross_bun,bear_claw,hot_cross_bun,bear_paw,bun]

coffee_shop=[#admirable,#interesting,kitchen,drink_coffee,food_and_beverage,beverage,eat_dinner]

coffin=[#scared,#disgusting,morgue,grave,headstone,casket,graveyard]

cognisant=[#interesting,#joyful,conscious,awake,sensible,alert,alive]

cognitive_factor=[#scared,#disgusting,inspiration,determinant,divine_guidance,determinative,difficulty]

cognizant=[#joyful,#admirable,alive,conscious,alert,sensible,awake]

coherence=[#joyful,#admirable,consistency,connectedness,connection,continuity,link]

coherency=[#interesting,#admirable,connectedness,link,consistency,continuity,connection]

coif=[#sad,#scared,marcelfure,hairstyle,hairdo,hair_style,marcel]

coiffure=[#disgusting,#angry,hair_style,marcel,hairstyle,hairdo,coif]

coiled=[#joyful,#surprising,convolute,rolled,convoluted,wound,involute]

coin_slot=[#joyful,#admirable,banknote,loose_change,paper_bill,spare_change,checkbook_cover]

coincidence=[#surprising,#admirable,math_homework,sign_autograph,character_play,role,write]

cold_air=[#interesting,#surprising,dew,cloudy,fog,spray,sleet]

cold_beer=[#joyful,#admirable,liquor,hold_liquor,whisky,alcohol,adult_drink]

cold_color=[#scared,#sad,yellow_blue,violet,color,cool_color,cyan]

cold_day=[#joyful,#interesting,bleak,no_sun,before_night,darkness,moon_star]

cold_head=[#scared,#disgusting,hair_become_short,new_look,short_hair,keep_hair_short,little_hair]

cold_night=[#sad,#angry,cuddle,windy,chilly,breeze,jacket]

cold_person=[#sad,#angry,busy_person,smart_man,delusional,use_illegal_drug,human]

cold_weather=[#surprising,#admirable,snow_fall,winter,put_warm_clothes,snowy,winter_time]

cold_winter=[#scared,#disgusting,hypothermia,freeze,possibility_to_die,severe_cold,cold]

cole=[#angry,#disgusting,kail,borecrucifer,kale,crucifer,cruciferwort]

colewort=[#scared,#angry,kale,cole,borecole,crucifer,kail]

colitis=[#sad,#angry,regional_enteritis,regional_ileitis,rubor,ulcerative_colitis,redness]

collage_film=[#interesting,#admirable,film,movie,flick,moving_picture,picture]

colleague=[#interesting,#admirable,public_servant,manager,laborer,worker,office_job]

collect_data=[#interesting,#admirable,make_drawing,make_noise,make_lot_noise,listen_heart,backup]

collect_ticket=[#scared,#angry,pay_ticket,sell_ticket,purchase_ticket,buy_ticket,ticket]

collection=[#joyful,#surprising,group,big_group,several_people,clique,mob]

college=[#angry,#disgusting,time_waster,time_waster_class,class,school,school_system]

college_course=[#joyful,#admirable,pupil,school_division,scholar,group_student,learning_place]

college_dorm=[#disgusting,#scared,shack,hostel,cabin,dormitory,student_home]

college_girl=[#sad,#angry,undergrad,lowerclassman,senior,collegian,underclassman]

college_professor=[#joyful,#interesting,reliability,good_teacher,husband_wife,smart_man,voyeur]

college_teacher=[#admirable,#interesting,professor,instructor,teach_lesson,lecturer,teacher]

college_tuition=[#scared,#angry,pay_tuition,private_tuition,enroll_class,enroll_school,tuition]

collegian=[#sad,#angry,college_girl,lowerclassman,undergrad,underclassman,senior]

collide=[#sad,#scared,float_through_air,spring_up,hold_two_together,collision,install_window]

colly=[#scared,#sad,muck_up,blemish,foul,muddy_up,smear]

colonnaded=[#joyful,#interesting,columned,pillared,amphistylar,columnar,columniform]

